缅怀[緬懷]	mian3huai2	verb literary cherish the memory of; recall 缅怀故人 miǎnhuái gùrén recall old friends 缅怀往事 miǎnhuái wǎngshì recall past events 缅怀先辈 miǎnhuái xiānbèi cherish the memory of one’s forefathers
羊驼[羊駝]	yang2tuo2	noun zoology alpaca (Lama alpacos)
懿[懿]	yi4	adjective literary (esp. of a woman) virtuous; exemplary 懿德 yìdé moral excellence 懿行 yìxíng exemplary conduct
麤[麤]	cu1	adjective 1 coarse; crude; rough (opp. 细) 粗沙 cūshā coarse sand; grit 粗黑的手 cū hēi de shǒu rough, work-soiled hands 这个活儿太粗了。 Zhège huór tài cū le. This is too slovenly a piece of work. 2 gruff; husky 粗嗓子 Cū sǎngzi husky voice 粗声大气 cū shēng dàqì a deep, gruff voice 3 careless; negligent 这人心太粗。 Zhè rénxīn tài cū. This guy is too careless. 4 rude; unrefined; vulgar 说话很粗 shuōhuà hěn cū speak rudely; use coarse language 5 wide (in diameter); thick (opp. 细) 一条粗绳 Yī tiáo cū shéng a thick rope 这棵树很粗。 Zhè kē shù hěn cū. This tree has a thick trunk.  adverb roughly; slightly 粗知一二 cūzhīyī'èr have a rough idea; know a little
骉[驫]	biao1	noun archaic galloping horses
睾酮[睾酮]	gao1tong2	1 testosterone 2 abbr. for 睾丸甾酮gāowánzāitóng [睾丸甾酮]
珠峰[珠峰]	Zhu1feng1	1 abbr. for 珠穆朗玛峰, Mt Chomolungma or Qomolangma (Tibetan) 2 Mt Everest 3 Nepalese: Sagarmatha
窗口[窗口]	chuang1kou3	noun 1 window 坐在窗口 zuò zài chuāngkǒu sit at (or by) the window 在对外开放中发挥窗口作用 Zài duìwài kāifàng zhōng fāhuī chuāngkǒu zuòyòng serve as a window to the outside world 去上海的火车票在那个窗口卖。 Qù Shànghǎi de huǒchēpiào zài nàge chuāngkǒu mài. Train tickets to Shanghai are sold at that window. 这个电视节目已成为人们了解世界的窗口。 zhège diànshì jiémù yǐ chéngwéi rénmen liǎojiě shìjiè dechuāngkǒu. The TV programme has turned out to be a window on the world. 2 computing window 关闭一个浏览器窗口 Guānbì yī ge liúlǎnqì chuāngkǒu close an IE window
鸿猷[鴻猷]	hong2 you2	great plan
轸念[軫念]	zhen3nian4	verb literary sorrowfully cherish the memory of; think anxiously about 殊深轸念 shūshēnzhěnniàn express great solicitude for
挽联[輓聯]	wan3lian2	noun elegiac couplet
吊唁[弔唁]	diao4yan4	1 to offer condolences (for the deceased) 2 to condole
超音速[超音速]	chao1yin1su4	noun supersonic speed
统一战线[統一戰線]	tong3yi1 zhan4xian4	noun united front
宥[宥]	you4	verb literary excuse; pardon; forgive 尚希见宥。 Shàngxī jiàn yòu. Please accept my apologies.
执事[執事]	zhi2shi4	1 to perform one's job 2 attendant 3 job 4 duties 5 (respectful appellation for the addressee) you 6 your Excellency 7 (Church) deacon
砚台[硯臺]	yan4tai5	noun inkstone; inkslab
横额[橫額]	heng2e2	noun 1 inscribed horizontal board 2 horizontal scroll bearing an inscription (usu. hung over a door and flanked by two vertical scrolls forming a couplet)
哔叽[嗶嘰]	bi4ji1	noun textile serge; twill
藏青[藏青]	zang4qing1	adjective dark blue
肃立[肅立]	su4li4	verb stand as a mark of respect 肃立默哀 sùlìmò'āi stand in silent mourning 奏国歌时全场肃立。 Zòu guógē shí quánchǎng sùlì. All stood as the band struck up the national anthem. or Everyone stood when the national anthem was played.
钢盔[鋼盔]	gang1kui1	noun (steel) helmet
冷峭[冷峭]	leng3qiao4	adjective literary 1 bitterly (or severely) cold 冷峭的风 lěngqiào de fēng chilly wind 2 sarcastic; caustic 冷峭的话 lěngqiào dehuà tart remarks 性情冷峭 xìngqíng lěngqiào have a sullen temper
阴霾[陰霾]	yin1mai2	noun literary usually figurative haze; cloudiness 生活在贫困的阴霾下 Shēnghuó zài pínkùn deyīnmái xià live under the shadow of poverty
撷取[擷取]	xie2qu3	1 to pick 2 to select 3 to take 4 to capture (data) 5 to acquire 6 to pick up (a signal)
蝎子[蠍子]	xie1zi5	scorpion
弹簧[彈簧]	tan2huang2	noun (metal) spring 保险弹簧 bǎoxiǎn tánhuáng relief spring 回动弹簧 huí dòng tánhuáng return spring
法统[法統]	fa3tong3	noun dated legally constituted authority
不吝[不吝]	bu4lin4	verb literary polite expression [asking advice] not stint; not grudge; generous with 尚希不吝指教(=赐教)。 Shàngxī bùlìn zhǐjiào. We hope that you will not spare your comments. or We hope that you will not stint your criticism.
触摸[觸摸]	chu4mo1	verb touch; feel 请勿触摸展品。 Qǐngwù chùmō zhǎnpǐn. Please don’t touch the exhibits.
届时[屆時]	jie4shi2	adverb literary when the time comes; at the appointed time; on the occasion 届时务请出席。 Jiè shíwù qǐng chūxí. Your presence is requested for the occasion. 大桥下月竣工, 届时将举行通车典礼。 Dà qiáo xiàyuè jùngōng, jièshí jiāng jǔxíng tōngchē diǎnlǐ. There will be first crossing ceremony next month when the bridge is completed.
花花公子[花花公子]	hua1hua1-gong1zi3	idiom playboy; dandy; coxcomb; fop
捉弄[捉弄]	zhuo1nong4	verb tease; make fun of; play tricks on
陶冶[陶冶]	tao2ye3	verb 1 make pottery and smelt metal 2 exert a favourable influence (on a person's character, etc.); mould 陶冶情操 táoyěqíngcāo cultivate one’s taste 陶冶性情 táoyě xìngqíng mould a person’s temperament; nurture character
无可奉告[無可奉告]	wu2ke3-feng4gao4	idiom no comment
括弧[括弧]	kuo4hu2	noun 1 parentheses (()) 2 VARIANT OF 25258496括号kuo4hao4括号2 brackets; parentheses ((),[ ],,【 】, etc., used as punctuation)/
神州[神州]	Shen2zhou1	noun Divine Land (a poetic name for China) 春风杨柳万千条, 六亿神州尽舜尧。(毛泽东) Chūnfēng yángliǔ wànqiān tiáo, liùyì Shénzhōu jìn Shùn Yáo. (Máo Zédōng) The spring wind blowing amid profuse willow wands, | Six hundred million in this Divine Land all Yaos and Shuns.
九州[九州]	Jiu3zhou1	noun 1 nine divisions of China in remote antiquity 2 poetic name for China 九州生气恃风雷。(龚自珍《己亥杂诗》) Jiǔzhōu shēngqì shì fēngléi. Only in wind and thunder can the country show its vitality. 3 Kyushu (Japanese island)
抚恤[撫卹]	fu3xu4	(of an organization that has a duty of care) to give financial support to relatives of sb who has died or suffered serious injury
戳[戳]	chuo1	verb 1 jab; poke; stab 一戳就破 yī chuō jiù pò break at the slightest touch 在纸上戳了一个洞 Zài zhǐ shàng chuō le yī ge dòng poke a hole in the paper 别用笔在书上戳。 Bié yòng bǐ zài shū shàng chuō. Don’t jab the book with your pen. 2 dialect sprain; blunt 打排球戳了手 dǎ páiqiú chuō le shǒu sprain one’s wrist while playing volleyball 钢笔尖儿戳了。 Gāngbǐ jiānr chuō le. The nib is blunted. 3 dialect stand sth. on end 把秫秸戳起来 Bǎ shújiē chuō qǐlai stand the bundle of sorghum stalks on end 有话进来说, 别在门口儿戳着。 Yǒu huà jìn láishuō, bié zài ménkǒur chuō zhe. Don’t stand in the doorway. Come in if you have something to say.  noun VARIANT OF 19110656戳子chuo1zi5戳子 colloquial stamp; seal
禁卫军[禁衛軍]	jin4wei4jun1	noun dated imperial guards
河殇[河殤]	He2shang1	River Elegy, influential 1988 CCTV documentary series, said to have stimulated the Beijing Spring democracy movement of 1980s
始末[始末]	shi3mo4	noun beginning and end—whole story 事情的始末 shìqing de shǐ-mò the whole story
周遭[週遭]	zhou1zao1	noun surrounding area 周遭静悄悄的, 不见一个人。 zhōuzāo jìngqiāoqiāo de, bùjiàn yī gèrén. It was very quiet all around with nobody in sight. 山围故国周遭在, 潮打空城寂寞回。(刘禹锡《石头城》) Shān wéi gùguó zhōuzāo zài, cháo dǎ kōngchéng jìmò huí. Hills surround the ancient kingdom; they never change. | The tide beats against the empty city, and silently, silently returns.
银楼[銀樓]	yin2lou2	noun dated silverware (or jeweller's) shop
声东击西[聲東擊西]	sheng1dong1-ji1xi1	idiom make a feint to the east and attack in the west
倒卧[倒臥]	dao3wo4	verb lie down 倒卧在地 dǎo wò zài dì lie down on the ground
阁揆[閣揆]	ge2kui2	1 premier 2 prime minister
壅塞[壅塞]	yong1se4	verb be clogged up; be jammed; be congested 水道壅塞。 Shuǐdào yōng sè. The waterway is blocked up.
类推[類推]	lei4tui1	verb analogize; reason by analogy 照此类推 zhàocǐlèituī on the analogy of this 其余类推 qíyú lèituī reason out the rest by analogy
实例[實例]	shi2li4	noun living example; example 用实例说明 yòng shílì shuōmíng illustrate with examples
丰沛[豐沛]	feng1pei4	adjective literary (of rainfall) plentiful 雨水丰沛 yǔshuǐ fēngpèi have plenty of rain
伫列[佇列]	zhu4lie4	queue (computing)
铳[銃]	chong4	noun blunderbuss 鸟铳 niǎochòng an old kind of fowling piece
阁下[閣下]	ge2xia4	noun courteous Your (or His, Her) Excellency 大使阁下 Dàshǐ géxià Your Excellency Mr. Ambassador or His Excellency the Ambassador
升降机[升降機]	sheng1jiang4ji1	elevator; lift
博彩[博彩]	bo2cai3	noun lottery; tombola 博彩业 bócǎiyè lottery industry
揾[搵]	wen4	verb literary 1 press or rub with fingers 2 wipe
揾[搵]	wen3	1 to look for (Cantonese) 2 Mandarin equivalent: 找zhǎo [找]
筲箕[筲箕]	shao1ji1	noun bamboo basin (kitchen utensil for washing rice or vegetables)
岭[嶺]	ling3	noun 1 mountain; ridge 翻山越岭 fānshānyuèlǐng cross over mountain after mountain 2 mountain range 大兴安岭 Dàxīng'ānlǐng Greater Xing’an Mountains 小兴安岭 xiǎo xīng ān lǐng Lesser Xing’an Mountains 3 abbreviation the Five Ridges
荃湾[荃灣]	Quan2wan1	Tsuen Wan district of New Territories, Hong Kong
生还者[生還者]	sheng1huan2zhe3	survivor
豚[豚]	tun2	noun 1 suckling pig 2 pig
铨叙部[銓敘部]	Quan2xu4bu4	Ministry of Civil Service, Taiwan
栓[栓]	shuan1	noun 1 bolt; plug; pin 枪栓 qiāngshuān rifle bolt 2 stopper; cork 栓式按钮 shuān shì ànniǔ bolt-push piece
正楷[正楷]	zheng4kai3	noun calligraphy regular script
卅[卅]	sa4	number thirty 五卅惨案 Wǔ sà cǎn'àn the May 30th Massacre (1925, in Shanghai)
玺印[璽印]	xi3yin4	seal (esp. of ruler)
首推[首推]	shou3tui1	verb 1 considered as first or best-known 这方面的专家首推张教授。 zhè fāngmiàn de zhuānjiā shǒutuī zhāng jiàoshòu. Of the experts in this realm Professor Zhang is the first to mention. 2 first choose; first recommend 首推营养食品 shǒutuī yíngyǎng shípǐn nutritious food first recommended 3 first launch; first release 国内厂家首推车型 guónèi chǎngjiā shǒutuī chēxíng car model first launched by domestic company
谜团[謎團]	mi2tuan2	noun doubts and suspicions 揭开谜团 jiēkāi mítuán resolve doubts; solve the mystery
隶属[隸屬]	li4shu3	verb be subordinate to; be under the jurisdiction (or command) of 隶属关系 lì shǔ guān xì relationship of administrative (or semantic, etc.) subordination 隶属医科大学的医院 lìshǔ yīkē dàxué de yīyuàn hospital attached to a medical university 这支部队隶属市警备区。 Zhè zhī bùduì lìshǔ shì jǐngbèiqū. This unit is under the command of the municipal garrison. 直辖市直接隶属国务院。 zhíxiáshì zhíjiē lìshǔ Guówùyuàn. A province-level municipality is under the direct control of the State Council.
弧菌[弧菌]	hu2jun1	noun vibrio
真知灼见[真知灼見]	zhen1zhi1-zhuo2jian4	idiom real knowledge and deep insight; penetrating judgment
越王勾践[越王勾踐]	Yue4 Wang2 Gou1 Jian4	King Gou Jian of Yue (c. 470 BC), sometimes considered one of the Five Hegemons 春秋五霸
吴王阖闾[吳王闔閭]	Wu2wang2 He2 Lü2	1 King Helu of Wu (-496 BC, reigned 514-496 BC), sometimes considered one of the Five Hegemons 春秋五霸 2 also called 吴王阖庐
楚庄王[楚莊王]	Chu3 Zhuang1wang2	King Zhuang of Chu (reigned 613-591 BC), one of the Five Hegemons 春秋五霸
秦穆公[秦穆公]	Qin2 Mu4gong1	Duke Mu of Qin, the first substantial king of Qin (ruled 659-621 BC), sometimes considered one of the Five Hegemons 春秋五霸
宋襄公[宋襄公]	Song4 Xiang1gong1	Duke Xiang of Song (reigned 650-637 BC), sometimes considered one of the Five Hegemons 春秋五霸
晋文公[晉文公]	Jin4 Wen2gong1	Duke Wen of Jin (697-628 BC, reigned 636-628 BC), one of the Five Hegemons 春秋五霸
齐桓公[齊桓公]	Qi2 Huan2gong1	Duke Huan of Qi (reigned 685-643 BC), one of the Five Hegemons 春秋五霸
瓜分[瓜分]	gua1fen1	verb cut up a melon—carve up; dismember; partition; divide up 瓜分财产 guāfēn cáichǎn divide up property 瓜分领土 guāfēn lǐngtǔ carve up the territory
兼并[兼併]	jian1bing4	verb annex (territory, property, etc.); acquire; merge; take over 企业兼并 qǐ yè jiān bìng amalgamation of enterprises 土地兼并 tǔdi jiānbìng land annexation 武力兼并邻国领土 wǔlì jiānbìng línguó lǐngtǔ annex the territories of a neighbouring country by force
愉悦[愉悅]	yu2yue4	adjective joyful; cheerful; delighted 心情愉悦 xīnqíng yúyuè in a highly delighted mood
辈出[輩出]	bei4chu1	verb come forth in large numbers; prolific 英雄辈出的时代 yīngxióng bèichū de shídài an age of heroes 人才辈出。 réncái bèichū Many outstanding people are coming to the fore.
百家争鸣[百家爭鳴]	bai3jia1-zheng1ming2	idiom 1 contention between many schools of thought (during the Spring and Autumn and the Warring States Periods) 2 let a hundred schools of thought contend
争霸[爭霸]	zheng1ba4	verb contend (or struggle) for hegemony; scramble (or strive) for supremacy 争霸世界 zhēngbà shìjiè contend for world domination (or hegemony)
诸侯[諸侯]	zhu1hou2	noun dukes or princes owing loyalty to an emperor; nobles
兴起[興起]	xing1qi3	verb 1 rise; spring up; be on the upgrade 激光是六十年代初期兴起的一门新科学。 Jīguāng shì liùshí niándài chūqī xīngqǐ de yī mén xīn kēxué. Lasers are a new branch of science which rose in the early 1960s. 2 literary rise in excitement; be aroused
距今[距今]	ju4jin1	1 before the present 2 (a long period) ago
半坡[半坡]	Ban4po1	Banpo neolithic Yangshao culture archaeological site east of Xi'an 西安
河姆渡[河姆渡]	He2mu3du4	Hemudu neolithic archaeological site near Ningbo in Zhejiang, going back to c. 5000 BC
遗址[遺址]	yi2zhi3	noun site (where sth. was) 半坡遗址(新石器时代仰韶文化遗址, 在西安东郊半坡村) bàn pō yízhǐ (xīn shíqì shídài Yǎngsháo Wénhuà yízhǐ, zài Xī'ān dōngjiāo bàn pō cūn) Banpo Village site (a neolithic site of the Yangshao Culture, at Banpo Village on the eastern outskirts of Xi’an) 古城遗址 gǔchéng yízhǐ site of an ancient city 平型关战役遗址 píng xíng guān zhànyì yízhǐ site of the Battle of Pingxingguan (Sept. 1937)
韩战[韓戰]	Han2zhan4	Korean War (1950-1953)
投奔[投奔]	tou2ben4	verb go to (a friend or a place) for shelter 投奔亲戚 Tóubèn qīnqi seek refuge with relatives; go to one’s relatives for help
奻[奻]	nuan2	
认知[認知]	ren4zhi1	philosophy psychology verb cognize; understand  noun cognition
巧言令色[巧言令色]	qiao3yan2-ling4se4	idiom clever talk and an ingratiating manner 巧言令色, 鲜矣仁。(《论语》) Qiǎo yán lìng sè, xiān yǐ rén. (《Lúnyǔ》) Clever talk and an ingratiating manner are seldom found in a virtuous man.
区块链[區塊鏈]	qu1kuai4lian4	blockchain (computing)
轰隆[轟隆]	hong1long1	onomatopoeia rumble; roll 轰隆的机器声 Hōnglōng de jīqì shēng the hum of machines 雷声轰隆地响。 léishēng hōnglōng de xiǎng. Thunder rumbled.
党纲[黨綱]	dang3gang1	noun party programme
醒酒[醒酒]	xing3//jiu3	verb dispel the effects of alcohol; sober up 吃个梨醒醒酒。 Chī ge lí xǐngxǐngjiǔ. Have a pear to sober yourself up. 浓茶可以醒酒。 nóngchá kěyǐ xǐngjiǔ. Strong tea can help to dispel the effects of alcohol.
单亲[單親]	dan1qin1	noun single-parent
逊位[遜位]	xun4wei4	verb (of a king or queen) abdicate; renounce one's throne
丰腴[豐腴]	feng1yu2	adjective literary 1 VARIANT OF 21029376丰盈feng1ying2丰盈1 literary full and round; well-developed; plump 2 rich and fertile 丰腴的草场 fēngyú de cǎochǎng rich pasture 3 sumptuous 丰腴的酒席 fēngyú de jiǔxí sumptuous feast
颊[頰]	jia2	noun medicine cheek;  bucca 两颊红润 liǎng jiá hóngrùn with rosy cheeks 双颊凹陷 shuāng jiá āoxiàn sunken (or hollow) cheeks
蹄[蹄]	ti2	noun 1 hoof 马有四只蹄儿。 Mǎ yǒu sì zhī tí r. A horse has four hoofs. 2 trotter 猪蹄 zhūtí pig’s trotters
晌[晌]	shang3	noun 1 part of the day 前半晌儿 qiánbànshǎngr morning 天半晌儿 tiān bànshǎngr dusk 2 dialect noon 歇晌 xiēshǎng take a midday nap or rest
蔻丹[蔻丹]	kou4dan1	noun transliteration nail polish (from “Cutex”)
闩[閂]	shuan1	noun door bolt; latch 上闩 Shàngshuān fasten with a bolt (or latch)  verb fasten with a bolt or latch 把门闩上 bǎ ménshuān shàng bolt the door
童子鸡[童子雞]	tong2zi3ji1	noun dialect young chicken; broiler
叨登[叨登]	dao1deng5	verb colloquial 1 turn things over; move things around 把衣服叨登出来晒晒。 Bǎ yīfu dāo deng chū lái shài shài. Turn your clothes out to air them. 2 harp on things past 事情已经过去了, 还叨登什么？ Shìqing yǐjing guòqu le, hái dāo deng shénme？ Why harp on things already over and done with?
卤味[滷味]	lu3wei4	food prepared by stewing in soy sauce and spices
诓[誆]	kuang1	verb deceive; hoax; cheat 我哪能诓你？ Wǒ nǎ néng kuāng nǐ？ How could I deceive you?
膀[膀]	bang3	noun 1 upper arm; arm 2 shoulder 肩膀 jiānbǎng shoulder 3 wing (of a bird) 翅膀 chìbǎng wing
痢疾[痢疾]	li4ji5	noun medicine dysentery 细菌性痢疾 xìjūnxìnglìji bacillary dysentery
病殁[病歿]	bing4mo4	die of illness
成亲[成親]	cheng2//qin1	verb colloquial get married 他们是去年成的亲。 Tāmen shì qùnián chéng de qīn. They got married last year.
妖娆[妖嬈]	yao1rao2	adjective literary enchanting; fascinating; bewitching
远射[遠射]	yuan3she4	noun 1 sports (in football) long drive; long shoot 2 military long-range shooting
不遗余力[不遺餘力]	bu4yi2-yu2li4	idiom spare no pains (or effort); do one's utmost; leave no stones unturned 不遗余力地提供帮助 bùyíyúlì de tígōng bāngzhù do everything to help
敝[敝]	bi4	adjective literary 1 shabby; worn-out; ragged 敝衣 Bì yī ragged clothing; shabby (or worn-out) clothes 2 decline; degenerate 时政日敝。 Shízhèng rì bì. The political situation is deteriorating by the day. 3 self-deprecating my; our; this 敝处 bìchù my place 敝校 bìxiào my school 敝姓陈。 Bì xìng chén. My name is Chen.
心胸狭窄[心胸狹窄]	xin1xiong1 xia2zhai3	narrow-minded; intolerant
票匦[票匭]	piao4gui3	noun ballot box
瓯[甌]	ou1	noun dialect bowl; cup 金瓯 Jīn Ōu golden cup; golden vessel 酒瓯 jiǔ'ōu wine cup; drinking vessel  noun another name for Wenzhou (a city in Zhejiang Province) 瓯绣 ōuxiù Wenzhou embroidery
浣熊[浣熊]	huan4xiong2	noun zoology racoon
助纣为虐[助紂為虐]	zhu4Zhou4wei2nüe4	idiom aid King Zhou in his tyrannical rule—aid and abet an evil-doer; abet the wicked
崂山[嶗山]	Lao2shan1	noun Mount Lao (in Shandong Province)
庆生[慶生]	qing4sheng1	to celebrate a birthday
年终[年終]	nian2zhong1	noun end of the year; year-end
联网[聯網]	lian2//wang3	verb connect computers (or electricity wires, communication lines, etc.) to form a network; be online 联网发电 liánwǎng fādiàn generate electricity through network access 电脑联网 diànnǎo liánwǎng computer network
枸杞[枸杞]	gou3qi3	noun Chinese wolfberry
担子[擔子]	dan4zi5	noun 1 carrying (or shoulder) pole and the loads on it; load; burden 2 task 我们不怕担子重, 一定要把事情办好。 Wǒmen bù pà dànzi zhòng, yīdìng yào bǎ shìqing bàn hǎo. We’re not afraid of the heavy task and are determined to do a good job.
华尔兹[華爾茲]	hua2er3zi1	noun transliteration dance waltz
台儿庄[臺兒莊]	Tai2er2zhuang1	Tai'erzhuang district of Zaozhuang city 枣庄市Zǎozhuāngshì [枣庄市], Shandong
腰花[腰花]	yao1hua1	noun scalloped pork or lamb kidneys 炒腰花 chǎo yāohuā stir-fried kidneys
一行[一行]	yi1xing2	noun group travelling together; party 总统及其一行 zǒngtǒng jíqí yīxíng the President and accompanying officials 代表团一行十五人 Dàibiǎotuán yīxíng shíwǔ rén the fifteen-person delegation
风疹[風疹]	feng1zhen3	noun medicine rubella; German measles
讪笑[訕笑]	shan4xiao4	verb ridicule; jeer; sneer at; deride 不要讥笑别人的缺点。 Bùyào jīxiào biéren de quēdiǎn. Don’t laugh at other’s shortcomings.
龙须菜[龍鬚菜]	long2xu1cai4	noun botany asparagus
毛肚[毛肚]	mao2du3	tripe (gastronomy)
伕[伕]	fu1	noun 4 dated conscripted labourer 拉夫 lāfū pressgang
守夜[守夜]	shou3//ye4	verb keep watch at night; take the night watch
将才[將才]	jiang4cai2	noun 1 man with military talent; man born to command troops 2 ability to lead or command troops; generalship 别看他小小年纪, 却颇具将才。 Biékàn tā xiǎoxiǎo niánjì, què pō jù jiàngcái. Young as he is, he is a good commander.
将才[將纔]	jiang1cai2	adverb dialect just now; a moment ago 他将才还在这儿。 Tā jiāng cái hái zài zhèr. He was here a moment ago.
骊[驪]	li2	noun literary pure black horse  adjective black 骊龙 lílóng black dragon
昍[昍]	xuan1	
格式化[格式化]	ge2shi4hua4	verb computing format 将软盘格式化 jiāng ruǎnpán géshìhuà format a floppy disk
本省人[本省人]	ben3sheng3ren2	1 people of this province 2 (in Taiwan) Han Chinese people other than those who moved to Taiwan from mainland China after 1945 and their descendants
外省[外省]	wai4sheng3	noun provinces other than where one is; other provinces
货真价实[貨真價實]	huo4zhen1-jia4shi2	idiom 1 genuine goods at a fair price 2 through and through; out-and-out; dyed-in-the-wool; absolute 货真价实的骗子 huòzhēnjiàshí de piànzi an out-and-out swindler 货真价实的伪君子 huòzhēnjiàshí de wěijūnzǐ absolute hypocrite
翌年[翌年]	yi4nian2	next year
张贴[張貼]	zhang1tie1	verb put up (a notice, poster, etc.) 张贴海报 zhāngtiē hǎibào put up posters 张贴通告 zhāngtiē tōnggào post a notice 禁止张贴。 Jìnzhǐ zhāngtiē. Post no bills.
触手[觸手]	chu4shou3	noun zoology tentacle
凭吊[憑弔]	ping2diao4	1 to visit a place for the memories 2 to pay homage to (the deceased)
黑潮[黑潮]	hei1chao2	noun geography black stream; Kuroshio; Japan Current (or Stream)
蜗牛[蝸牛]	wo1niu2	noun zoology snail 食用蜗牛 shíyòng wōniú edible snail
踏青[踏青]	ta4qing1	verb walk on the green grass—go for an outing in early spring
夯[夯]	ben4	1 stupid 2 foolish 3 silly 4 slow-witted 5 clumsy
夯[夯]	hang1	noun rammer; tamper  verb 1 ram; tamp; pound 把土夯实 bǎ tǔ hāngshí ram the earth 2 dialect strike heavily 朝他背上夯一拳 Cháo tā bèishanghāng yī quán punch him on the back 3 dialect carry sth. heavy on one's shoulder
消融[消融]	xiao1rong2	verb (of ice or snow) melt; thaw 冰雪消融 Bīng-xuě xiāoróng melting of ice and snow 待到冰雪消融时 dài dào bīng-xuě xiāoróng shí wait till the thaw sets in
静听[靜聽]	jing4ting1	verb listen attentively; pay close attention
清寂[清寂]	qing1ji4	adjective cold and quiet
无常[無常]	wu2chang2	verb variable; changeable 变化无常 biànhuà-wúcháng constantly changing; changeable; capricious 反复无常 fǎnfùwúcháng behave capriciously; blow hot and cold; chop and change  noun astrology (Wúcháng) demon regarded as the messenger of death  verb euphemistic die 一旦无常万事休。 Yīdàn wúcháng wànshì xiū. When death comes, everything is over.
樱花[櫻花]	ying1hua1	noun oriental cherry 日本樱花 Rìběn yīnghuā Japanese flowering cherry
冼[冼]	Xian3	noun a surname
葶[葶]	ting2	meaningless bound form 
馨[馨]	xin1	noun literary strong and pervasive fragrance 如兰之馨 rúlánzhīxīn a strong and pervasive fragrance like the orchid’s
症结[癥結]	zheng1jie2	noun 1 original meaning lump in the abdomen 2 figurative crux; crucial reason 这就是问题的症结所在。 Zhè jiù shì wèntí de zhēngjié suǒzài. Therein lies the crux of the problem.
苏[甦]	su1	verb revive; come to 死而复苏 sǐ ér fùsū come back to life
蒋经国[蔣經國]	Jiang3 Jing1guo2	Chiang Ching-kuo (1910-1988), son of Chiang Kai-shek 蒋介石, Guomindang politician, president of ROC 1978-1988
自寻短见[自尋短見]	zi4xun2 duan3jian4	attempt suicide; commit suicide
杜鹃花[杜鵑花]	du4juan1hua1	Indian Azalea (Rhododendron simsii Planch)
辇[輦]	nian3	noun 1 archaic man-drawn carriage 2 imperial carriage  verb literary travel by carriage
蝈蝈[蟈蟈]	guo1guo5	1 katydid 2 long-horned grasshopper
雪藏[雪藏]	xue3cang2	verb 1 dialect freeze; refrigerate 雪藏果汁 xuěcáng guǒzhī cold fruit juice 2 figurative conceal; keep idle intentionally 教练把主力雪藏起来, 决赛再派上场。 jiàoliàn bǎ zhǔlì xuěcáng qǐlai, juésài zài pài shàngchǎng. The coach kept the top players till the final. 3 shelve; lay aside 涉毒艺人被雪藏。 Shè dú yìrén bèi xuěcáng. The star involved in drug trafficking was rested.
阵势[陣勢]	zhen4shi4	noun 1 battle array (or formation); disposition of combat forces 摆开阵势 bǎikāi zhènshì deploy the ranks in battle array; array 敌人的阵势全给打乱了。 Dírén de zhènshì quán gěi dǎluàn le. The enemy formations were completely broken up. 2 situation; condition; circumstances
体态[體態]	ti3tai4	noun posture; carriage 体态轻盈 tǐtàiqīngyíng have a graceful carriage
朱熹[朱熹]	Zhu1 Xi1	Zhu Xi or Chu Hsi (1130-1200), also known as Master Zhu 朱子, Song dynasty Confucian writer and propagandist, founder of neo-Confucianism
沉香[沉香]	chen2xiang1	noun 1 botany agalloch eaglewood (Aquilaria agallocha; Aquilaria sinensis) 2 wood of this plant
短见[短見]	duan3jian4	noun 1 short-sighted view; lack foresight 2 suicide 自寻短见 zìxún duǎnjiàn attempt suicide; commit suicide
丁香[丁香]	ding1xiang1	noun 1 lilac 2 clove 丁香油 dīngxiāngyóu clove oil
邮差[郵差]	you2chai1	noun dated postman; mailman
爵士[爵士]	jue2shi4	noun 1 knight 2 Sir 约翰·史密斯爵士 Yuē hàn·shǐ mìsī juéshì Sir John Smith  noun transliteration jazz
皋[皋]	gao1	noun literary 1 marshland; waterside land 皋陆 gāolù marshland and highland 2 marsh; bog 皋泽 gāozé wetland
蝉联[蟬聯]	chan2lian2	verb continue to hold (a post or title) 多次蝉联全国冠军 Duō cì chánlián quánguó guànjūn win the national championship several times running
法则[法則]	fa3ze2	noun 1 VARIANT OF 22100480规律gui1lv4规律 law; regular pattern 2 literary laws and regulations 3 literary model
渔歌[漁歌]	yu2ge1	noun fisherman's song 渔歌唱和 yúgē chànghè one fisherman singing and others joining in
胭脂[胭脂]	yan1zhi5	noun rouge
陈年[陳年]	chen2nian2	adjective of long standing; preserved for a long time 陈年老酒 Chénnián lǎojiǔ old vintage wine
平湖[平湖]	Ping2hu2	Pinghu county level city in Jiaxing 嘉兴Jiāxīng [嘉兴], Zhejiang
风月[風月]	feng1yue4	noun 1 wind and moon—scene; view 风月清幽 Fēngyuè qīngyōu tranquil and exquisite scene 2 romantic affairs 风月场中 fēngyuèchǎngzhōng in the arena (or tournaments) of love
蓬莱[蓬萊]	Peng2lai2	noun 1 fabled abode of immortals 蓬莱仙境 Pénglái xiānjìng fairyland 2 a city in Shandong Province
落脚[落腳]	luo4//jiao3	verb 1 set (or plant) one's foot on; get a foothold on 那辆公共汽车挤得无处落脚。 Nà liàng gōnggòng qìchē jǐ de wúchù luòjiǎo. That bus was too crowded to get on. 2 stay (for a time); stop over; put up 在客店落脚 zài kèdiàn luòjiǎo put up at an inn 找个地方落个脚 Zhǎo ge dìfang luò ge jiǎo find a place to stay
昆仑[崑崙]	Kun1lun2	noun Kunlun Mountains
曲肱而枕[曲肱而枕]	qu1gong1er2zhen3	sleep with one’s head resting on one’s bent arm
邬[鄔]	Wu1	noun a surname
沙乌地阿拉伯[沙烏地阿拉伯]	Sha1wu1di4 A1la1bo2	Saudi Arabia (Tw)
殊荣[殊榮]	shu1rong2	noun special honours
打滑[打滑]	da3hua2	verb 1 skid around 车轮在泥里打滑。 Chēlún zài ní lǐ dǎhuá. The wheels skidded around in the mud. 2 slip (on a slippery ground)
考量[考量]	kao3liang5	verb consider; deliberate
镭射[鐳射]	lei2she4	noun laser
蓁[蓁]	zhen1	noun 1 botany hazel 2 hazelnut
斑鸠[斑鳩]	ban1jiu1	noun ornithology turtledove
柿子椒[柿子椒]	shi4zi5jiao1	noun sweet pepper; bell pepper
花椒[花椒]	hua1jiao1	noun 1 botany Chinese prickly ash 2 seeds of this plant
白胡椒[白胡椒]	bai2hu2jiao1	white peppercorn
黑胡椒[黑胡椒]	hei1hu2jiao1	noun black pepper
吞金[吞金]	tun1//jin1	verb swallow gold (to commit suicide)
入声[入聲]	ru4sheng1	noun linguistics entering tone (the fourth of the four tones in classical Chinese pronunciation, still retained in certain dialects)
亚斯伯格[亞斯伯格]	Ya4si1bo2ge2	Hans Asperger (1906-1980), Austrian pediatrician
调情[調情]	tiao2qing2	verb flirt; dalliance 跟吧女调情 gēn bānǚ tiáoqíng flirt with a bargirl
脚本[腳本]	jiao3ben3	noun script; scenario; libretto 脚本错误 jiǎoběn cuòwù script error 电影脚本 diànyǐng jiǎoběn film script
终端用户[終端用戶]	zhong1duan1yong4hu4	end-user
莴苣[萵苣]	wo1ju5	noun lettuce
糗[糗]	Qiu3	surname Qiu
谐音[諧音]	xie2yin1	noun 1 euphony 2 music partials 3 homophony  verb have the same pronunciation 这两个字谐音。 zhè liǎng ge zì xiéyīn. These two characters are homophonic.
集思广益[集思廣益]	ji2si1-guang3yi4	idiom draw on collective wisdom and absorb all useful ideas; pool the wisdom of the masses
弹牙[彈牙]	tan2ya2	al dente
台巴子[台巴子]	Tai2ba1zi5	Taiwanese yokel (derog.)
呼啦圈[呼啦圈]	hu1la1quan1	hula hoop (loanword)
未命名[未命名]	wei4ming4ming2	1 untitled 2 unnamed 3 no name 4 nameless 5 unknown name
摩羯[摩羯]	Mo2jie2	1 Capricorn (star sign) 2 northern people in classical times, a branch of the Huns or Xiongnu 匈奴
造诣[造詣]	zao4yi4	noun (academic or artistic) attainments 他是一位造诣很高的学者。 Tā shì yī wèi zàoyì hěn gāo de xuézhě. He is a scholar of great attainments. 她是一位很有造诣的歌唱家。 Tā shì yī wèi hěn yǒu zàoyì de gēchàngjiā. She’s an accomplished singer.
龟裂[龜裂]	jun1lie4	verb 1 (of parched earth) full of cracks 长期干旱, 田地龟裂。 Chángqī gānhàn, tiándì jūnliè. There has been no rain for a long time and the fields are full of cracks. 2 VARIANT OF 24763392皲裂jun1lie4皲裂 jūnliè (of skin) chapped; cracked
皲裂[皸裂]	jun1lie4	verb (of skin) chapped; cracked
滑稽[滑稽]	hua2ji5	noun folk art comic talk (popular in Shanghai, Hangzhou, and Suzhou, and similar to comic cross-talk in northern China)  adjective funny; amusing; comical 他样子很滑稽。 Tā yàngzi hěn huáji. He is funny-looking. 丑角的表演非常滑稽。 Chǒujué de biǎoyǎn fēicháng huáji. The clown gave a very funny performance.
反骨[反骨]	fan3gu3	noun dated treacherous nature 此人有反骨。 cǐrén yǒu fǎngǔ. The man is a traitor by nature.
铜板[銅板]	tong2ban3	noun 1 dialect copper coin; copper 2 music copper clappers (a percussion instrument used in cross talk) 3 metallurgy copper sheet
同温层[同溫層]	tong2wen1ceng2	stratosphere
冲压[沖壓]	chong4ya1	1 to stamp 2 to press (sheet metal) 3 Taiwan pr. [chōngyā]
螺帽[螺帽]	luo2mao4	noun mechanics (screw) nut 紧螺母 jǐn luómǔ tighten (or fasten) the nut 蝶形螺母 diéxíng luómǔ butterfly (or wing) nut 六角螺母 liùjiǎo luómǔ hexagonal nut
猪瘟[豬瘟]	zhu1wen1	noun swine fever; hog cholera
讵[詎]	ju4	adverb literary [in rhetorical questions] 讵料天气骤寒。 Jù liào tiānqì zhòu hán. Who could have expected the weather to turn cold so suddenly?
良辰[良辰]	liang2chen2	noun literary 1 auspicious occasion; propitious time 良辰吉日 liángchénjírì auspicious hour and lucky day 2 fine day; pleasant times
金蝉脱壳[金蟬脫殼]	jin1chan2-tuo1qiao4	idiom slip out of a predicament like a cicada sloughing its skin—escape by cunning manoeuvring
东芝[東芝]	Dong1zhi1	Toshiba, Japanese electronics company
清口[清口]	qing1kou3	adjective tasty and refreshing
锏[鐧]	jian3	noun archaic mace
寡人[寡人]	gua3ren2	noun I, your unworthy king (corresponding to the English royal “we”) 梁惠王曰:“寡人之于国也, 尽心焉耳矣。”(《孟子》) liáng huì wáng yuē: “guǎrén zhī yú guó yě, jìnxīn yān ěr yǐ.” King Hui of Liang said, “I have done my best for my state.”
铜锣[銅鑼]	tong2luo2	gong
铙钹[鐃鈸]	nao2bo2	noun music big cymbals
笙箫[笙簫]	sheng1xiao1	reed-pipe wind instrument and vertical bamboo flute
福祉[福祉]	fu2zhi3	noun literary happiness; blessedness; well-being
统战[統戰]	tong3zhan4	noun abbreviation VARIANT OF 31663104统一战线tong3yi1zhan4xian4统一战线 united front  verb unite; win over
因应[因應]	yin1ying4	verb 1 cope (or deal) with 因应变局 yīnyìng biànjú cope with changes 因应市场的需求 yīnyìng shìchǎng de xūqiú deal with market demands 2 adapt oneself to; comply with; conform to 因应挑战 yīnyìng tiǎozhàn adapt oneself to challenges 针对形势的变化而妥善因应 zhēnduì xíngshì de biànhuà ér tuǒshàn yīnyìng comply with the changes of the situation
无视[無視]	wu2shi4	verb ignore; disregard; defy 无视别国主权 Wúshì bié guó zhǔquán disregard the sovereignty of other countries 无视人民的意志 wúshì rénmín de yìzhì defy the will of the people; fly in the face of the people; defy popular sentiment
戈雷[戈雷]	ge1lei2	gray (unit of absorbed dose of ionizing radiation) (loanword) (Tw)
戈瑞[戈瑞]	ge1rui4	gray (unit of absorbed dose of ionizing radiation) (loanword)
佳肴[佳餚]	jia1yao2	noun delicacies 美味佳肴 Měiwèi jiāyáo delicious food
姜饼[薑餅]	jiang1bing3	gingerbread
小幺儿[小么兒]	xiao3yao1r5	noun dated page boy
踅[踅]	chi4	walk with one leg
踅[踅]	xue2	verb walk to and fro; turn back halfway 他在大门口踅来踅去。 Tā zài dàménkǒu xué lái xué qù. He was hanging about the gate.
腊肠[臘腸]	la4chang2	noun sausage
箍[箍]	gu1	verb bind round; hoop 用铁丝把桶箍上 yòng tiěsī bǎ tǒng gū shàng bind a bucket with wire 他头上箍着条毛巾。 Tā tóu shàng gū zhe tiáo máojīn. He had a towel wound round his head.  noun hoop; band 铁箍 tiěgū iron hoop
开屏[開屏]	kai1//ping2	verb (of a peacock) spread its tail; display its fine tail feathers
走马灯[走馬燈]	zou3ma3deng1	noun running-horse lantern (a lantern with a decorative upper panel, which revolves as the hot air ascends) 人员不断更换, 就像走马灯似的。 Rényuán bùduàn gēnghuàn, jiù xiàng zǒumǎdēng shìde. Personnel constantly shifted like on a running-horse lantern (or a merry-go-round).
风化[風化]	feng1hua4	noun morals and manners; decency 有伤风化 yǒushāng fēnghuà an offence against decency  verb 1 geology weather 风化的岩石 fēnghuà de yánshí weathered rock 2 chemistry efflorescence
鲠[鯁]	geng3	noun fishbone  verb (of a fishbone) get stuck in one's throat  adjective literary upright
逼肖[逼肖]	bi1xiao4	verb literary bear a close resemblance to; be the very image of
逼真[逼真]	bi1zhen1	adjective 1 lifelike; true to life 这幅画画得十分逼真。 zhè fú huà huà de shífēn bīzhēn. This painting is really true to life (or lifelike). 2 distinct; clear 听得逼真 Tīng de bīzhēn hear distinctly 看得逼真 kàn de bīzhēn have a clear view of sth.
飒[颯]	sa4	literary onomatopoeia rustle; sough  verb wither  adjective (of women) natural and unrestrained; elegant; valiant
褛[褸]	lü3	noun front part of a Chinese-style jacket  adjective literary worn-out; in rags See 25351168褴褛lan2lv3褴褛lánlǚ
冶[冶]	ye3	verb smelt (metal) 冶铸 yězhù smelt and found  adjective literary pejorative seductively dressed or made up 妖冶 yāoyě seductive; bewitching
班师[班師]	ban1shi1	verb literary withdraw troops from the front; return after victory 班师归来 bānshī guīlái make a triumphant return
夔[夔]	Kui2	1 one-legged mountain demon of Chinese mythology 2 Chinese mythical figure who invented music and dancing 3 Chinese rain god 4 surname Kui
犹自[猶自]	you2zi4	adverb literary still 忆及此事, 犹自心惊。 Yìjí cǐshì, yóuzì xīnjīng. Even to this day, I still shudder at the very thought of it.
姘[姘]	pin1	verb have illicit relations with; commit adultery
造化[造化]	zao4hua4	literary noun Creator; Nature; Creation 造化钟神秀, 阴阳割昏晓。(杜甫《登泰山》) zàohuà zhōng shénxiù, yīnyáng gē hūnxiǎo. Here Creation concentrated unearthly glory, | Dark north slope, the sunlit south divide dusk and dawn. 造化赋形, 支体必双, 神理为用, 事不孤立。(刘勰《文心雕龙》) zàohuà fù xíng, zhī tǐ bì shuāng, shén lǐ wéi yòng, shì bù gūlì. Nature, creating living beings, endows them with limbs in pairs. The Divine Reason operates in such a way that nothing stands alone.  verb (of Nature or presumed divine force) create; make 夺天地造化之功 duó tiāndì zàohuà zhī gōng rob Heaven and Earth of their creative powers
道台[道臺]	dao4tai2	noun archaic intendant of a circuit (an administrative division)
公仔[公仔]	gong1zai3	1 doll 2 cuddly toy
单帮[單幫]	dan1bang1	noun dated travelling trader working on his own 跑单帮 pǎo dānbāng travel around trading on one’s own
锂[鋰]	li3	noun chemistry lithium (Li) 锂电池 lǐdiànchí lithium cell (or battery)
迳自[逕自]	jing4zi4	1 on one's own 2 without consulting others
衣衾[衣衾]	yi1qin1	noun dated burial clothes 衣衾棺 yīqīn guān burial clothes and coffin
螭[螭]	chi1	noun mythology hornless dragon-like animal (as decorative motif in Chinese architecture, arts and crafts, etc.)  meaningless bound form VARIANT OF 18691328魑chi1魑
冷杉[冷杉]	leng3shan1	noun botany fir; fir tree
雏凤[雛鳳]	chu2feng4	noun young phoenix—talented young 雏凤清于老凤声。(李商隐《韩冬郎即席为诗相送因成二绝》) chúfèng qīng yú lǎo fèng shēng. A young phoenix sings better than an old one. [said of a son surpassing his father or of a student surpassing his master].
嶒[嶒]	ceng2	1 lofty 2 precipitous
崚[崚]	leng2	lofty (as of mountain)
诸子百家[諸子百家]	zhu1zi3-bai3jia1	noun history various schools of thought and their exponents during the period from pre-Qin times to the early Han Dynasty
无异[無異]	wu2yi4	verb no different from; tantamount to; as good as 这件复制品几乎与原作无异。 Zhè jiàn fùzhìpǐn jīhū yǔ yuánzuò wúyì. The reproduction is almost as good as the original. 他撤回声明无异于表示歉意。 Tā chèhuí shēngmíng wúyì yú biǎoshì qiànyì. The withdrawal of his statement is tantamount to an apology.
弃之如敝屣[棄之如敝屣]	qi4 zhi1 ru2 bi4xi3	idiom cast away like a pair of worn-out shoes
敝屣[敝屣]	bi4xi3	noun literary worn-out shoes; worthless thing See 28245248弃之如敝屣qi4zhi1ru2bi4xi3弃之如敝屣;30238464视如敝屣shi4ru2bi4xi3视如敝屣
细嚼慢咽[細嚼慢嚥]	xi4jiao2man4yan4	to eat slowly (idiom)
与世隔绝[與世隔絕]	yu3shi4-ge2jue2	idiom be secluded from the real world; withdraw into one's shell 过着与世隔绝的日子 guò zhe yǔshìgéjué de rìzi live an isolated life
芃[芃]	peng2	meaningless bound form 
运将[運將]	yun4jiang4	driver (of a taxi etc) (loanword from Japanese) (Tw)
马杀鸡[馬殺雞]	ma3sha1ji1	massage (loanword)
铁马[鐵馬]	tie3ma3	noun literary iron-clad (or armoured) horses—strong mounted forces 夜阑卧听风吹雨, 铁马冰河入梦来。(陆游《十一月四日风雨大作》) yèlán wò tīng fēng chuī yǔ, tiěmǎ bīnghé rùmèng lái. Night deepening, I lie and listen to winds buffeting the rain, ｜ And iron-clad horses over frozen rivers come charging into my dreams. See 24232960金戈铁马jin1ge1tie3ma3金戈铁马  noun tinkling pieces of metal hanging from the eaves of pagodas, temples, etc.; metal windchimes
相称[相稱]	xiang1cheng1	verb call each other; address each other (as ...) 以姐弟相称 Yǐ jiědì xiāngchēng address each other as brother and sister
相称[相稱]	xiang1chen4	adjective match; suit 这头巾跟你的年龄不相称。 Zhè tóujīn gēn nǐ de niánlíng bù xiāngchèn. This kerchief doesn’t suit a person of your age. 这两种颜色配在一起很相称。 Zhè liǎng zhǒng yánsè pèi zài yīqǐ hěn xiāngchèn. The two colours match very well. 你这种工作作风与党员的称号很不相称。 Nǐ zhèzhǒng gōngzuò zuòfēng yǔ dǎngyuán de chēnghào hěn bù xiāngchèn. Your work style is not worthy of a Party member.
速配[速配]	su4pei4	1 fast matchmaking 2 speed dating 3 (coll.) (Tw) (of a couple) to be a good match
直译[直譯]	zhi2yi4	verb word-for-word (or literal) translation (opp. 意译)
优酪乳[優酪乳]	you1luo4ru3	yogurt (loanword) (Tw)
奇异果[奇異果]	qi2yi4guo3	1 kiwi fruit 2 Chinese gooseberry
太白粉[太白粉]	tai4bai2fen3	1 cornstarch 2 potato starch
洗面乳[洗面乳]	xi3mian4ru3	cleansing lotion
洗发精[洗髮精]	xi3fa4jing1	(liquid) shampoo
保险套[保險套]	bao3xian3tao4	condom M: 只zhī [只]
子宫颈癌[子宮頸癌]	zi3gong1jing3ai2	cervical cancer
超音波[超音波]	chao1yin1bo1	1 ultrasound 2 ultrasonic wave
卷舌[卷舌]	juan3she2	verb (in pronunciation) curl up the tip of the tongue
羁押[羈押]	ji1ya1	verb literary detain; take into custody
政绩[政績]	zheng4ji4	noun achievements of one's official career
弄璋[弄璋]	nong4zhang1	verb dated play with a jade tablet—a son is born (from the early custom of giving a baby boy a jade tablet to play with, symbol of male superiority) See 27463424弄瓦nong4wa3弄瓦
削发[削髮]	xue1fa4	verb cut off the hair 削发为僧 xuēfàwéisēng have one’s head shaved to enter the monkhood ; take the tonsure 削发为尼 xuēfàwéiní have one’s head shaved to enter the nunhood; take the tonsure
维权[維權]	wei2quan2	verb abbreviation safeguard legitimate rights and interests 为消费者维权 wèi xiāofèizhě wéiquán protect consumers’ interests
简报[簡報]	jian3bao4	noun bulletin; brief report 会议简报 huìyì jiǎnbào conference bulletin; brief reports on conference proceedings
累累[纍纍]	lei2lei2	1 (literary) (of fruit, achievements etc) clusters of 2 piles of 3 heaps of 4 gaunt 5 haggard 6 wretched 7 Taiwan pr. [lěilěi]
犹[猶]	you2	literary verb just as; like 虽死犹生 suīsǐyóushēng live on in spirit  adverb still 犹未定夺 yóu wèi dìngduó still undecided; not decided yet 犹有可为 yóuyǒukěwéi can still do something about it
暴戾[暴戾]	bao4li4	adjective literary ruthless and tyrannical; cruel and fierce
木屐[木屐]	mu4ji1	noun clogs
精虫[精蟲]	jing1chong2	noun physiology spermatozoon; sperm
踢毽子[踢毽子]	ti1 jian4zi5	kick the shuttlecock (as a game)
软实力[軟實力]	ruan3shi2li4	noun soft power
儦[儦]	biao1	walking to and fro
伉[伉]	kang4	archaic verb (of a married couple) fit for each other; equal to  adjective high; mighty
从无到有[從無到有]	cong2wu2dao4you3	grow out of nothing
何去何从[何去何從]	he2qu4-he2cong2	idiom what course to follow 何去何从,  速作抉择。 Héqùhécóng, sù zuò juézé. What course to follow—that is a question you must quickly decide for yourself.
产能[產能]	chan3neng2	production capacity
供应链[供應鏈]	gong1ying1lian4	supply chain
出逃[出逃]	chu1tao2	verb flee 出逃国外 Chūtáo guówài flee the country
持久战[持久戰]	chi2jiu3zhan4	protracted war; protracted warfare
越演越烈[越演越烈]	yue4yan3yue4lie4	1 to be intensifying 2 to be getting worse and worse 3 to start to run rampant
手语[手語]	shou3yu3	noun sign language; dactylology
莲雾[蓮霧]	lian2wu4	noun botany wax-apple; wax-jambo
纵使[縱使]	zong4shi3	conjunction literary even if; even though
忍辱负重[忍辱負重]	ren3ru3-fu4zhong4	idiom endure humiliation in order to carry out an important mission
顾全大局[顧全大局]	gu4quan2da4ju2	take the interests of the whole into account; consider the situation as a whole
鞠躬尽瘁[鞠躬盡瘁]	ju1gong1-jin4cui4	idiom bend oneself to a task and exert oneself to the utmost; spare no effort in the performance of one's duty 鞠躬尽瘁, 死而后已 jūgōngjìncuì, sǐ'érhòuyǐ bend one’s back to the task until one’s dying day; give one’s all till the very end
病入膏肓[病入膏肓]	bing4ru4gao1huang1	idiom The disease has attacked the vitals.—beyond cure 他已病入膏肓, 自知时日无几。 tā yǐ bìngrùgāohuāng, zìzhī shírì wújǐ. He is beyond cure and knows his days are numbered.
附议[附議]	fu4yi4	verb second a motion; support a proposal 我附议！ Wǒ fùyì! I second the motion!
义和团[義和團]	Yi4he2tuan2	noun history Yihetuan (an anti-imperialist armed organization established by north China peasants and handicraftsmen in 1900)
缔约[締約]	di4yue1	verb conclude (or sign) a treaty 缔约双方 dìyuēshuāngfāng both contracting parties
辅仁大学[輔仁大學]	Fu3ren2 Da4xue2	1 Fu Jen Catholic University of Peking (from 1925), forerunner of Beijing Normal University 北京师范大学 2 Fu Jen Catholic University in New Taipei City, Taiwan
饯别[餞別]	jian4bie2	verb give a farewell dinner 饯别友人 jiànbié yǒurén give a friend a farewell dinner
成事不足，败事有余[成事不足，敗事有餘]	cheng2shi4bu4zu2, bai4shi4you3yu2	1 unable to accomplish anything but liable to spoil everything (idiom) 2 unable to do anything right 3 never make, but always mar
伏笔[伏筆]	fu2bi3	noun hint foreshadowing later developments in a story, essay, etc.; foreshadowing 这件事为以后情节的发展埋下了伏笔。 zhè jiàn shì wèi yǐhòu qíngjié de fāzhǎn máixià le fúbǐ. This episode carries a foreshadowing of what is to follow later on in the story.
制衡[制衡]	zhi4heng2	verb check and balance 在大国之间起着制衡的作用 Zài dàguó zhījiān qǐ zhe zhìhéng de zuòyòng hold the balance between big powers
覗[覗]	si1	peek
适者生存[適者生存]	shi4zhe3-sheng1cun2	idiom survival of the fittest
背道而驰[背道而馳]	bei4dao4er2chi2	idiom run in the opposite direction; run counter to 和他们的愿望背道而驰 hé tāmen de yuànwàng bèidào'érchí run counter to their intentions; opposite to their intentions 同改革的要求背道而驰 tóng gǎigé de yāoqiú bèidào'érchí contradict the whole purpose of reforms 与党的方针背道而驰 yǔdǎng de fāngzhēn bèidào'érchí in diametrical opposition to the Party’s policy
物竞天择[物競天擇]	wu4jing4-tian1ze2	idiom survival of the fittest in natural selection
忿忿不平[忿忿不平]	fen4fen4bu4ping2	1 to feel indignant 2 to feel aggrieved
塞责[塞責]	se4ze2	verb not do one's job conscientiously; perform one's duties perfunctorily See 60377315敷衍塞责fu1yan5se4ze2敷衍塞责
而后[而後]	er2hou4	conjunction then; after that; afterwards 我们先研究一下, 然后再决定。 Wǒmen xiān yánjiū yīxià, ránhòu zài juédìng. We’ll consider the problem carefully before coming to any decision. 我们看了一场电影, 然后就回家了。 Wǒmen kàn le yī chǎng diànyǐng, ránhòu jiù huíjiā le. We saw a film, and then (we) went home.
定能[定能]	ding4neng2	to be definitely able (to do sth)
莫大[莫大]	mo4da4	adjective greatest; utmost 莫大的愤慨 mò dà de fènkǎi utmost indignaion 莫大的侮辱 mò dà de wǔrǔ gross insult 莫大的幸福 mò dà de xìngfú greatest happiness; bliss 感到莫大的光荣 Gǎndào mòdà de guāngróng feel greatly honoured
纸浆[紙漿]	zhi3jiang1	noun paper pulp; pulp
纸板[紙板]	zhi3ban3	noun paperboard; cardboard 纸板盒(箱) zhǐbǎnhé(xiāng) cardboard case or box; carton
鼩鼱[鼩鼱]	qu2jing1	noun zoology shrew
啮齿[嚙齒]	nie4chi3	a rodent (rat, rabbit etc)
变速器[變速器]	bian4su4qi4	gearbox; transmission
谷物[穀物]	gu3wu4	noun 1 cereal; grain 2 abbreviation VARIANT OF 21864448谷类作物gu3lei4zuo4wu4谷类作物 general name for rice, wheat, millet, sorghum, maize, etc.; cereal crops
蜂鸟[蜂鳥]	feng1niao3	noun ornithology hummingbird
明文规定[明文規定]	ming2wen2 gui1ding4	written rules (or provisions); explicit terms; expressly stated
受众[受眾]	shou4zhong4	noun audience
饲育[飼育]	si4yu4	verb literary raise; feed
木乃伊[木乃伊]	mu4nai3yi1	noun mummy
金字塔[金字塔]	jin1zi4ta3	noun pyramid
都会[都會]	du1hui4	noun big city; metropolis
涂装[塗裝]	tu2zhuang1	1 painted ornament 2 livery (on airline or company vehicle)
舫[舫]	fang3	noun boat 画舫 huàfǎng gaily-painted pleasure-boat
疏浚[疏浚]	shu1jun4	verb dredge 疏浚港口 shūjùn gǎngkǒu dredge a harbour 疏浚水道 Shūjùn shuǐdào dredge the waterways
浚渫[浚渫]	jun4xie4	to dredge
桦树[樺樹]	hua4shu4	noun botany birch
岷山[岷山]	min2 shan1	Mount Min (along the border between Sichuan and Gansu Provinces)
晨曦[晨曦]	chen2xi1	noun first rays of the morning sun
测绘[測繪]	ce4hui4	verb survey and map; map 地形测绘 Dìxíng cèhuì topographical survey
铨[銓]	quan2	noun archaic steelyard; balance  verb literary 1 weigh; measure; judge 2 select; choose
浮想联翩[浮想聯翩]	fu2xiang3-lian2pian1	idiom thoughts thronging one's mind 浮想联翩, 夜不能寐。 Fúxiǎngliánpiān, yè bùnéng mèi. Thoughts thronged my mind and I could not sleep.
竣工[竣工]	jun4//gong1	verb (of a project) completed (opp. 开工) 竣工仪式 jùngōng yíshì completion ceremony 这座大楼已提前竣工。 Zhè zuò dàlóu yǐ tíqián jùngōng. The building has been completed ahead of schedule.
歼灭[殲滅]	jian1mie4	verb annihilate; wipe out; destroy 歼灭性的打击 jiānmiè xìng de dǎjī crushing blow; smashing blow 歼灭敌人有生力量 jiānmiè dírén yǒushēng lìliàng wipe out the enemy’s effective strength 歼灭一切敢于入侵之敌 jiānmiè yīqiè gǎnyú rùqīn zhī dí destory any enemy that should dare to intrude
齿轮[齒輪]	chi3lun2	noun gear wheel; gear 伞齿轮 sǎn chǐlún bevel gear 外齿轮 wài chǐlún external gear 斜齿轮 xié chǐlún helical gear 正齿轮 zhèng chǐlún spur gear
泷[瀧]	Shuang1	noun Shuangshui River (in Guangdong Province)
泷[瀧]	long2	noun dialect rapids [often in place names] 七里泷 qī lǐ lóng Qililong (a village in Zhejiang Province)
藉由[藉由]	jie4you2	1 by means of 2 through 3 by
涵盖[涵蓋]	han2gai4	verb cover; contain; encompass 涵盖多种学科的计划 hángài duōzhǒng xuékē de jìhuà programme covering a wide range of disciplines
全方位[全方位]	quan2fang1wei4	adjective all-round
业界[業界]	ye4jie4	noun business circles
孩提[孩提]	hai2ti2	noun literary early childhood; infancy 我在故乡度过了孩提时代。 wǒ zài gùxiāng dùguò le háití shídài. I spent my childhood in my hometown.
扉页[扉頁]	fei1ye4	noun printing title page
如火如荼[如火如荼]	ru2huo3-ru2tu2	idiom like a raging fire 全国掀起了如火如荼的改革热潮。 Quánguó xiānqǐ le rúhuǒrútú de gǎigé rècháo. Reform is catching on like fire throughout the country.
物是人非[物是人非]	wu4shi4-ren2fei1	idiom The scenery remains the same but the people are changed. or Things are unchanged but the people are gone.
文法[文法]	wen2fa3	noun 1 rules of composition and rhetoric 2 VARIANT OF 35249920语法yu3fa3语法 grammar 中国文法 Zhōngguó wénfǎ Chinese grammar
程式[程式]	cheng2shi4	noun 1 form; pattern; formula 程式动作 chéngshì dòngzuò stylized movements (as in Beijing opera) 公文程式 gōngwén chéngshì forms and formulas of official documents 2 procedure; course
软体[軟體]	ruan3ti3	1 software (Tw) 2 soft-bodied (animal)
学测[學測]	Xue2ce4	abbr. for 大学学科能力测验   Dàxué Xuékē Nénglì Cèyàn [大学学科能力测验]
联考[聯考]	lian2kao3	entrance examination
简讯[簡訊]	jian3xun4	noun news in brief
锦鲤[錦鯉]	jin3li3	koi (Cyprinus carpio haematopterus)
鲜少[鮮少]	xian3shao3	1 very few 2 rarely
堆肥[堆肥]	dui1fei2	noun argriculture compost; compost heap
厨余[廚餘]	chu2yu2	1 kitchen waste 2 food waste (recycling)
崁[崁]	kan4	noun [in place names] 赤崁楼 Chìkànlóu Chikan Tower (a historic site in southern Taiwan)
著称[著稱]	zhu4cheng1	verb literary celebrated; famous 以风景优美著称 yǐ fēngjǐng yōuměi zhùchēng celebrated for its scenic beauty; well known for its lovely scenery 杭州以西湖著称于世。 Hángzhōu yǐ Xī Hú zhùchēng yú shì. Hangzhou is world-famous for its West Lake.
祝融[祝融]	Zhu4rong2	noun mythology God of Fire
流标[流標]	liu2biao1	verb 1 fail to be sold at auction (because of no bids) 拍卖品全部成交, 无一流标。 pāimài pǐn quánbù chéngjiāo, wú yī liúbiāo. All the items were bid for and sold at the auction. 2 become abortive tender 该项目由于竞标者均未达要求而流标。 Gāi xiàngmù yóuyú jìngbiāo zhě jūn wèi dá yāoqiú ér liúbiāo. The project became abortive because none of the bidders met the requirements.
无地自容[無地自容]	wu2di4-zi4rong2	idiom nowhere to hide one's shame; feel too ashamed to show one's face; look for a hole to crawl into
拜伦[拜倫]	Bai4lun2	George Byron (1788-1824), English poet
叠罗汉[疊羅漢]	die2 luo2han4	noun sports acrobatics pyramid
学潮[學潮]	xue2chao2	noun student unrest; campus upheaval 闹学潮 nào xuécháo stage student strike
为虎作伥[為虎作倀]	wei4hu3-zuo4chang1	idiom play the jackal to the tiger—help a rascal commit villainy
觑[覷]	qu1	verb narrow (one's eyes); squint 他觑着眼睛仔细地看一幅画。 Tā qū zhe yǎnjing zǐxì de kàn yī fú huà. He was studying a painting with narrowed eyes. 这英俊小伙子走过她身边, 她偷偷地觑了他一眼。 Zhè yīngjùn xiǎohuǒzi zǒuguò tā shēnbiān, tā tōutōu de qū le tā yī yǎn. She had a squint at the handsome young man as he passed by.
觑[覷]	qu4	verb literary look; gaze 面面相觑 miànmiànxiāngqù look at each other in blank dismay; gaze at each other in speechless despair
玄关[玄關]	xuan2guan1	noun 1 Buddhism entrance to Buddhism 2 dated front door 3 architecture entrance hall (of an apartment or a house); vestibule; porch
儒雅[儒雅]	ru2ya3	adjective literary scholarly and refined; well-educated 儒雅风度 rúyǎ fēngdù scholarly bearing
恂恂自下[恂恂自下]	xun2 xun2 zi4 xia4	be modest; be unassuming
烟斗[煙斗]	yan1dou3	noun 1 (tobacco) pipe 2 ceramic ball or mouthpiece of an opium pipe
饯行[餞行]	jian4xing2	verb give a farewell dinner 设宴为他饯行 shèyàn wéi tā jiànxíng give a farewell dinner for him
接风[接風]	jie1//feng1	verb give a welcome dinner (to a visitor from afar)
晾晒[晾曬]	liang4shai4	verb sun; air; sun-cure 晾晒稻米 liàngshài dàomǐ field the rice 把被褥彻底晾晒一下 bǎ bèirù chèdǐ liàngshài yīxià give the bedding a thorough airing
棉絮[棉絮]	mian2xu4	noun 1 cotton fibre 2 cotton wadding (for a quilt, etc.); cotton batting
褴褛[襤褸]	lan2lü3	adjective literary ragged; shabby 褴褛衣衫 lánlǚ yīshān tattered garments See 34451456衣衫褴褛yi1shan1lan2lv3衣衫褴褛
栖住[棲住]	qi1zhu4	1 to dwell 2 to live
地检署[地檢署]	di4jian3shu3	district prosecutor's office
都更案[都更案]	du1geng1an4	urban development project
口臭[口臭]	kou3chou4	verb (-//-) have bad breath  noun medicine halitosis; ozostomia
重荷[重荷]	zhong4he4	noun literary heavy burden (or responsibilities) 肩负重荷 jiānfù zhòng hè carry heavy responsibilities; burdened with heavy duties
沆瀣[沆瀣]	hang4xie4	noun literary evening mist
洞察[洞察]	dong4cha2	verb see clearly; have an insight into; discern 洞察是非 dòngchá shìfēi see clearly the rights and wrongs of the case; distinguish between right and wrong 洞察一切 dòngchá yīqiè have a keen insight into matters
乱码[亂碼]	luan4ma3	noun computing error (or unintelligible) codes
御史[御史]	yu4shi3	imperial censor (formal title of a dynastic official)
兄台[兄臺]	xiong1tai2	brother (polite appellation for a friend one's age)
大驾[大駕]	da4jia4	noun humorous your good self—you
平易[平易]	ping2yi4	adjective 1 unassuming; amiable 2 (of language, style, etc.) simple; easy; plain 用平易的表达 Yòng píngyì de biǎodá in simple words
更上一层楼[更上一層樓]	geng4 shang4 yi1 ceng2 lou2	idiom climb one storey higher—attain a yet higher goal; scale new heights 欲穷千里目, 更上一层楼。(王之涣《登鹳雀楼》) Yù qióng qiānlǐ mù, gèngshàngyīcénglóu. If you would command a prospect of a thousand li, climb one storey higher.
洗耳恭听[洗耳恭聽]	xi3er3-gong1ting1	idiom listen with respectful attention
摇篮曲[搖籃曲]	yao2lan2qu3	music lullaby; berceuse; cradle song
帖子[帖子]	tie3zi5	noun 1 invitation 请帖 qǐngtiě invitation card; invitation 2 note; card 字帖儿 zìtiěr brief note 3 internet post; posting; thread 顶帖 Dǐng tiě bump a thread 发帖 fātiě post; put up a post 回帖 huítiě reply to one’s post; post a reply
猣[猣]	zong1	dog giving birth to three puppies
鸮[鴞]	xiao1	noun ornithology owl
熟门熟路[熟門熟路]	shu2men2-shu2lu4	idiom familiar road and familiar door—things that one knows well
双面[雙面]	shuang1mian4	adjective two-sided; double-edged; double-faced; reversible
擀面杖[擀麵杖]	gan3mian4zhang4	noun rolling pin
籴[糴]	di2	verb dated buy in (grain) (opp. 粜 tiào)
岘港[峴港]	Xian4gang3	Da Nang or Danang, Vietnam
荷包[荷包]	he2bao5	noun 1 small bag (for carrying money and odds and ends); pouch 2 pocket (in a garment)
远道而来[遠道而來]	yuan3dao4er2lai2	come a long way; come from afar
斡旋[斡旋]	wo4xuan2	verb mediate 由于他从中斡旋, 双方的争端得到了解决。 Yóuyú tā cóng zhōng wòxuán, shuāngfāng de zhēngduān dédào le jiějué. Through his mediation, the dispute between the two parties was settled.  noun legal good offices
趸[躉]	dun3	adverb wholesale 趸售 dǔnshòu (sell) wholesale  verb buy wholesale 趸货 dǔnhuò buy goods wholesale
琼[瓊]	qiong2	noun literary fine jade 琼阁 qiónggé jewelled palace
甯[甯]	Ning4	noun a surname
钧[鈞]	jun1	measure word archaic jun (unit of weight, equal to 30 jin) 千钧之力 Qiān jūn zhī lì as powerful as being able to lift a thousand jun  pronoun literary courteous [said to one's seniors or superiors] you; your 钧命 jūnmìng your instructions
翊[翊]	yi4	verb literary assist (a ruler) 翊戴 yìdài assist and support (a ruler)
