香草[香草]	vanilla 香草冰激凌 xiāngcǎo bīngjilíng vanilla ice cream	xiang1cao3	noun

酥[酥]	1 shortbread 杏仁酥 xìngrén sū almond shortbread; 2 (archaic) VARIANT OF su1you2 酥油 butter adjective; 1 crisp; short 酥饼 sūbǐng flaky pastry 酥糖 sūtáng crunchy candy; crisp sweets; 2 (of a person's limbs) limp; weak; soft	su1	noun, adjective

胗[胗]	gizzard 鸡胗儿 Jī zhēnr chicken’s gizzard	zhen1	noun

贡丸[貢丸]	pork ball	gong4wan2	unknown

蒟[蒟]	betel pepper	ju3	noun

芋头[芋頭]	1 taro; 2 (dialect) sweet potato	yu4tou5	noun

阴平[陰平]	(linguistics) high and level tone (the first of the four tones in modern standard Chinese pronunciation) (See si4sheng1 四声)	yin1ping2	noun

去声[去聲]	1 falling tone (third of the four tones in classical Chinese pronunciation); 2 falling tone (fourth of the four tones in modern standard Chinese pronunciation) (See si4sheng1 四声)	qu4sheng1	noun

死对头[死對頭]	merciless and deadly enemy; sworn enemy; irreconcilable opponent	si3dui4tou5	noun

轰[揈]	shoo away; drive off 轰麻雀 hōng máquè shoo away the sparrows 轰下台 hōng xiàtái hoot sb. off the platform; oust sb. from office (or power) 把他轰出去。 Bǎ tā hōng chūqu. Throw him out.	hong1	verb

济南[濟南]	Jinan (capital of Shandong Province)	Ji3nan2	unknown

盛情难却[盛情難卻]	It would be ungracious not to accept your kindness.	sheng4qing2-nan2que4	idiom

峇里[峇里]	Bali (island province of Indonesia)	Ba1li3	unknown

奶瓶[奶瓶]	feeding (or nursing) bottle; (baby's) bottle	nai3ping2	noun

束修[束修]	payment for private tutor	shu4xiu1	unknown

姬妾[姬妾]	concubines	ji1qie4	unknown

荨麻疹[蕁麻疹]	(qiánmázhěn 〈旧〉) noun (medicine) nettle rash; urticaria	xun2ma2zhen3	unknown, noun

月老[月老]	1 Old Man of the Moon (god of marriage); 2 matchmaker; go-between	yue4lao3	noun

前奏[前奏]	1 VARIANT OF qian2zou4qu3 前奏曲 (music) prelude; 2 prelude 德国入侵波兰是第二次世界大战的前奏。 Déguó rùqīn Bōlán shì dì-èr cì shìjiè dàzhàn de qiánzòu. The German invasion of Poland was a prelude to World War II.	qian2zou4	noun

前来[前來]	usually (literary) come 今天他举行婚礼, 许多同事前来贺喜。 Jīntiān tā jǔxíng hūnlǐ, xǔduō tóngshì qiánlái hèxǐ. Today is his wedding day and many of his colleagues came to congratulate him.	qian2lai2	verb

不克[不克]	1 (literary) unable to; cannot 不克胜任 Bù kè shèngrèn unequal to the job; not up to the job; 2 fail to capture 屡攻不克 lǚ gōng bùkè repeated unsuccessful attacks	bu4ke4	verb

敬请[敬請]	(polite expression) invite respectfully 敬请斧正。 Jìngqǐng fǔzhèng. Would you be kind enough to correct my poor work? 敬请光临。 Jìngqǐng guānglín. Your presence is cordially requested. 敬请指教。 Jìngqǐngzhǐjiào. Kindly give me your advice.	jing4qing3	verb

凑热闹[湊熱鬧]	1 (colloquial) join in the fun; 2 add trouble to 我们够忙的, 别再来凑热闹了。 Wǒmen gòu máng de, bié zài lái còu rènao le. We’re busy enough as it is, don’t give us more trouble.	cou4//re4nao5	verb

收尾[收尾]	(-//-) bring to a conclusion; wind up 我们正在做收尾工作。 Wǒmen zhèngzài zuò shōuwěi gōngzuò. We are winding up the job. or We are in the last stages of the job. 你的文章可以用一句格言收尾。 Nǐ de wénzhāng kěyǐ yòng yī jù géyán shōuwěi. Try to wind up your essay with an aphorism. noun ending (of an article, etc.) 这个剧本收尾太平淡。 zhège jùběn shōuwěi tàipíng dàn. The ending of the play is flat.	shou1wei3	verb, noun

实务[實務]	1 practice (customary action, as opposed to theory); 2 practical	shi2wu4	unknown

多愁善感[多愁善感]	sentimental and susceptible; overly sentimental; weak and emotional	duo1chou2-shan4gan3	idiom

矽谷[矽谷]	Silicon Valley	Xi1gu3	unknown

硒[硒]	(chemistry) selenium (Se)	xi1	noun

我司[我司]	our company (polite)	wo3si1	unknown

晶片[晶片]	(electronics) wafer	jing1pian4	noun

唱片[唱片]	phonograph (or gramophone) record; disc 放唱片 fàng chàngpiàn play a phonograph record 灌唱片 guàn chàngpiàn cut a disc (or CD) 白金唱片 báijīn chàngpiàn platinum record 激光唱片 jīguāng chàngpiàn laser disc 密纹唱片 mìwén chàngpiàn compact disc	chang4pian4	noun

御玺[御璽]	imperial seal; (UK) privy seal	yu4xi3	noun

钛[鈦]	(chemistry) titanium (Ti)	tai4	noun

甜不辣[甜不辣]	1 tempura; 2 deep-fried cooking; 3 also called 甜不辣tiánbùlà [甜不辣]	tian2bu4la4	unknown

三八[三八]	(dialect) (vulgar) [usu. said of a woman] flighty; batty; foolish 她这人真三八！ tā zhè rén zhēn sānbā! What a flighty person she is! noun March 8	san1ba1	adjective, noun

垒球[壘球]	(sports) softball 打垒球 dǎ lěiqiú play softball	lei3qiu2	noun

参展[參展]	participate in an exhibition	can1//zhan3	verb

包在我身上[包在我身上]	1 leave it to me (idiom); 2 I'll take care of it	bao1zai4wo3shen1shang5	unknown, idiom

打卡[打卡]	clock; punch a card 上下班打卡 Shàngxiàbān dǎkǎ clock (or punch) in and out	da3//ka3	verb

坊[坊]	1 lane [usu. in street or lane names] 白纸坊 báizhǐ fāng White Paper Lane (a street in Beijing); 2 shop 茶坊 cháfāng teahouse; 3 memorial archway (See pai2fang5 牌坊)	fang1	noun

费心[費心]	1 give a lot of care; take a lot of trouble 她为这些孩子可费了不少心。 Tā wèi zhèxiē háizi kě fèi le bùshǎo xīn. She devoted a lot of care to these children.; 2 (polite expression) [making a request or giving thanks] may I trouble you (to do sth.); would you mind (doing sth.) 您见到他时, 费心把这封信交给他。 Nín jiàndào tā shí, fèixīn bǎ zhè fēng xìn jiāogěi tā. Will you be so kind as to give him this letter when you see him? 您帮了我们大忙, 费心了！ Nín bāng le wǒmen dàmáng, fèixīn le! You’ve helped us a lot. Thank you very much for taking all that trouble.	fei4//xin1	verb

劳烦[勞煩]	(dialect) (polite expression) may I…; trouble; please 劳烦您关上门。 láofán nín guān shàngmén. Do you mind shutting the door?	lao2fan2	verb

莅[蒞]	(literary) (courteous) arrive; be present 莅场 Lìchǎng be present on the occasion 莅任 lìrèn (of officials) assume one’s office; arrive at the post 莅席 lì xí be present at a banquet	li4	verb

榭[榭]	pavilion or house on a terrace 水榭 shuǐxiè waterside pavilion	xie4	noun

标竿[標竿]	1 benchmark; 2 pole serving as mark or symbol; 3 pole with a trophy hung on it	biao1gan1	unknown

王室[王室]	1 royal family; 2 imperial (or royal) court	wang2shi4	noun

视讯[視訊]	video (Tw)	shi4xun4	unknown

骇客[駭客]	hacker	hai4ke4	noun

笔友[筆友]	penfriend; pen pal	bi3you3	noun

裹脚[裹腳]	(dated) (of girls) bind one's feet; foot-binding	guo3//jiao3	verb

读心术[讀心術]	mind reading (in psychology or Western magic)	du2xin1shu4	unknown

樊[樊]	surname Fan	Fan2	unknown

千秋[千秋]	1 a thousand years; centuries; 2 (courteous) birthday (other than one's own)	qian1qiu1	noun

别有[別有]	1 to have other...; 2 to have a special ...	bie2you3	unknown

秋千[鞦韆]	swing (seat hung from a frame or branch)	qiu1qian1	unknown

轻佻[輕佻]	frivolous; flippant; giddy 举止轻佻 Jǔzhǐ qīngtiāo flippant (or skittish) behaviour	qing1tiao1	adjective

鞋垫[鞋墊]	shoe-pad; insole	xie2dian4	noun

倚天屠龙记[倚天屠龍記]	Heaven Sword and Dragon Saber, wuxia (武侠wǔxiá [武侠], martial arts chivalry) novel by Jin Yong 金庸 Jīn Yōng [金庸] and its screen adaptations	Yi3tian1 Tu2long2 Ji4	unknown

次长[次長]	vice-minister	ci4zhang3	noun

球员[球員]	player	qiu2yuan2	noun

鲷[鯛]	(ichthyology) porgy	diao1	noun

主修[主修]	1 specialize (in a subject); major (opp. 辅修,副修) 她主修原子物理。 Tā zhǔxiū yuánzǐ wùlǐ. She majors in atomic physics.; 2 responsible for the repair or overhaul (of a machine) 王师傅主修这台磨床。 Wáng shīfu zhǔxiū zhè tái móchuáng. Master worker Wang is responsible for the overhaul of this grinder.	zhu3xiu1	verb

好险[好險]	1 to have a close call; 2 to have a narrow escape	hao3xian3	unknown

体统[體統]	decorum; propriety; decency 有失体统 yǒushī tǐtǒng disgraceful; scandalous 他这样无理取闹, 成何体统！ Tā zhèyàng wúlǐqǔnào, chéng hé tǐtǒng! He’s just being difficult and it’s so embarrasing! (See bu4cheng2ti3tong3 不成体统)	ti3tong3	noun

仕途多蹇[仕途多蹇]	official career fraught with difficulties and danger; difficult career	shi4tu2duo1jian3	unknown

影集[影集]	1 photograph (or picture, photo) album; 2 TV miniseries; soap opera	ying3ji2	noun

断气[斷氣]	1 breathe one's last; die; 2 cut off the gas; gas stoppage	duan4//qi4	verb

急诊[急診]	1 emergency call; emergency treatment 挂急诊 Guà jízhěn register as an emergency case 这病不能耽误, 上医院看急诊吧。 Zhè bìng bù néng dānwu, shàng yīyuàn kàn jízhěn ba. This kind of illness allows no delay. Go right to hospital for emergency treatment.; 2 emergency (case)	ji2zhen3	noun

句点[句點]	full stop; period (。)(.)	ju4dian3	noun

跟踪狂[跟蹤狂]	stalker	gen1zong1kuang2	unknown

人生何处不相逢[人生何處不相逢]	it's a small world (idiom)	ren2sheng1he2chu4bu4xiang1feng2	unknown, idiom

沸点[沸點]	boiling point (opp. 冰点)	fei4dian3	noun

冰点[冰點]	(physics) freezing point (opp. 沸点) 温度降到冰点。 Wēndù jiàngdào bīngdiǎn. The temperature fell below freezing.	bing1dian3	noun

多普勒[多普勒]	Christian Johann Doppler, Austrian physicist who discovered the Doppler effect	Duo1pu3le4	unknown

不可或缺[不可或缺]	indispensable; vital 水和空气为生命所不可或缺。 Shuǐ hé kōngqì wéi shēngmìng suǒ bùkěhuòquē. Water and air are indispensable to life.	bu4ke3-huo4que1	idiom

先驱[先驅]	be the first to explore, develop, innovate, etc.; forerun noun pioneer; forerunner; harbinger 聂耳, 冼星海是中国革命音乐的先驱。 Niè Ěr, Xiǎn Xīnghǎi shì Zhōngguó gémìng yīnyuè dexiānqū. Nie Er and Xian Xinghai were pioneers of China’s revolutionary music.	xian1qu1	verb, noun

呷[呷]	(dialect) sip 呷一口茶 xiā yī kǒu chá take a sip of tea	xia1	verb

首屈一指[首屈一指]	come first on the list; second to none 老王的棋艺在我们公司是首屈一指的。 lǎo wáng de qíyì zài wǒmen gōngsī shì shǒuqūyīzhǐ de. Lao Wang is the best chess player in our company.	shou3qu1-yi1zhi3	idiom

降伏[降伏]	subdue; vanquish; tame 降伏野马 xiángfú yěmǎ break in a wild horse 谁降伏得了那野小子？ Shuí xiángfú déle nà yě xiǎozi？ Who can tame that unruly boy?	xiang2fu2	verb

波茨坦[波茨坦]	Potsdam (a city near Berlin)	Bo1ci2tan3	noun

甲午战争[甲午戰爭]	Sino-Japanese War of 1894-1895 (launched by Japanese imperialists to annex Korea and invade China)	Jia3wu3 Zhan4zheng1	noun

将士[將士]	(literary) officers and men; commanders and fighters	jiang4shi4	noun

船只[船隻]	shipping; vessels 船只失事 chuánzhī shīshì shipwreck 往来船只 wǎnglái chuánzhī shipping traffic 载货船只 zàihuò chuánzhī carrying vessels	chuan2zhi1	noun

苦橙[苦橙]	bitter orange	ku3cheng2	noun

静候佳音[靜候佳音]	awaiting the news of your success	jing4hou4 jia1yin1	unknown

惊魂[驚魂]	state of being frightened; fearful 惊魂稍定 Jīnghún shāo dìng barely recovered from a fright	jing1hun2	noun

迷雾[迷霧]	1 dense fog; 2 miasma; unhealthy or evil influence; anything that misleads people	mi2wu4	noun

标语[標語]	slogan; poster 张贴标语 zhāngtiē biāoyǔ put up slogans (or posters)	biao1yu3	noun

图腾[圖騰]	(transliteration) totem	tu2teng2	noun

壱[壱]	one (banker's anti-fraud numeral)	yi1	unknown

圻[圻]	1 (archaic) boundary; 2 (Qí) a surname	qi2	noun

跟屁虫[跟屁蟲]	1 (pejorative) shadow; person who follows another closely; 2 toady; lackey	gen1pi4chong2	noun

白垩[白堊]	chalk (a type of limestone)	bai2e4	noun

矽藻[矽藻]	diatom	xi1zao3	unknown

鼯鼠[鼯鼠]	(zoology) flying squirrel (Petaurista)	wu2shu3	noun

猛犸象[猛獁象]	mammoth	meng3ma3xiang4	unknown

白目[白目]	1 (slang) stupid; 2 moron	bai2mu4	unknown

顺产[順產]	(medicine) natural labour; normal childbirth; eutocia (opp. 难产) 婴儿顺产。 yīng'ér shùnchǎn The baby was born after an easy labour.	shun4chan3	verb

邮票[郵票]	postage stamp; stamp 邮票面值 yóupiào miànzhí face value of a postage stamp 特种邮票 tèzhǒng yóupiào special stamps 一套纪念邮票 Yī tào jìniàn yóupiào a set of commemorative stamps	you2piao4	noun

寻衅滋事[尋釁滋事]	pick quarrels and stir up trouble	xun2xin4zi1shi4	unknown

绮[綺]	(literary) noun figured woven silk material; damask adjective beautiful; gorgeous 绮思 qǐsī beautiful thoughts (in literature)	qi3	unknown, adjective, noun

标枪[標槍]	(sports) javelin	biao1qiang1	noun

啤酒花[啤酒花]	(botany) hops (Humulus lupulus)	pi2jiu3hua1	unknown

麦芽[麥芽]	malt 麦芽酶 màiyá méi maltose	mai4ya2	noun

金桔[金桔]	kumquat	jin1ju2	unknown

酵母[酵母]	yeast	jiao4mu3	noun

机车[機車]	locomotive; engine	ji1che1	noun

九宫[九宮]	(music) modes of ancient Chinese music	jiu3gong1	noun

篁[篁]	1 (literary) bamboo grove 幽篁 yōuhuáng secluded and restful bamboo grove; 2 bamboo 修篁 xiū huáng tall bamboos	huang2	noun

肉松[肉鬆]	dried meat (esp. pork) floss	rou4song1	noun

回形针[迴形針]	paper clip	hui2xing2zhen1	noun

专案[專案]	special case for investigation; case 这件事应成立专案。 Zhè jiàn shì yīng chénglì zhuān'àn. This should be made a special case for investigation.	zhuan1an4	noun

切结书[切結書]	1 affidavit; 2 written pledge	qie4jie2shu1	unknown

沿袭[沿襲]	carry on as before; follow 沿袭陈规 Yánxí chénguī follow convention 沿袭成说 yánxí chéngshuō adopt an accepted theory 沿袭已久的框框 yánxí yǐjiǔ de kuàngkuang long-standing restrictions	yan2xi2	verb

充电宝[充電寶]	1 portable charger; 2 mobile power pack	chong1dian4bao3	unknown

章鱼[章魚]	octopus	zhang1yu2	noun

朝日[朝日]	Asahi (Japanese place name, company name etc)	Zhao1ri4	unknown

桧[檜]	VARIANT OF yuan2bai3 圆柏 yuánbǎi noun (botany) Chinese juniper (Juniperus chinensis)	gui4	unknown, noun

簠[簠]	(archaic) square grain receptacle used at sacrificial ceremonies	fu3	noun

簋[簋]	(archaic) round-mouthed food vessel with two or four loop handles	gui3	noun

奎[奎]	1 (archaic) (astronomy) kui (the fifteenth of the twenty-eight zodiacal constellations (二十八宿) into which the celestial sphere was divided, consisting of sixteen stars, said to be like a person striding, in Pisces) 奎宿九 kuí xiǔ jiǔ Mirach; 2 (Kuí) a surname	kui2	noun

林立[林立]	(of masts, smokestacks, derricks, tall buildings, etc.) stand (in great numbers) like a forest 港口樯桅林立。 Gǎngkǒu qiáng wéi línlì. There is a forest of masts in the harbour.	lin2li4	verb

鲁蛇[魯蛇]	(slang) loser (loanword) (Tw)	lu3she2	unknown

艋舺[艋舺]	Mengjia (also written Monga, Monka or Bangka), the pre-Japanese-era name for Wanhua 万华Wànhuá [万华], the oldest district of Taipei	Meng3jia3	unknown

鹭鸶[鷺鷥]	(ornithology) egret	lu4si1	noun

枫树[楓樹]	Chinese sweet gum (Liquidambar formosana)	feng1shu4	noun

巡回[巡迴]	go the rounds; tour; make a circuit of 剧团正在全国各地巡回演出。 Jùtuán zhèng zài quánguó gè dì xúnhuí yǎnchū. The theatrical troupe is touring the country. 教师到放牧点上进行巡回教学。 Jiàoshī dào fàngmù diǎn shàng jìnxíng xúnhuí jiàoxué. The teachers make a circuit of the herding centres to give lessons.	xun2hui2	verb

殷切[殷切]	ardent; eager 殷切的期望 yīnqiè de qīwàng ardent expectations	yin1qie4	adjective

河内[河內]	Hanoi, capital of Vietnam	He2nei4	unknown

札幌[札幌]	Sapporo, Japan	Zha2huang3	unknown

冲绳[沖繩]	Okinawa	Chong1sheng2	unknown

琉球[琉球]	Ryukyu (Islands)	Liu2qiu2	noun

火烧眉毛[火燒眉毛]	The fire is singeing the eyebrows.—a desperate situation; at a crucial point 火烧眉毛的事儿 Huǒ shāo méimao de shìr matter of the utmost urgency	huo3shao1-mei2mao5	idiom

航厦[航廈]	airline terminal	hang2sha4	unknown

芳苑[芳苑]	Fangyuan township in Changhua county 彰化县Zhānghuàxiàn [彰化县], Taiwan	Fang1yuan4	unknown

彰化[彰化]	Zhanghua or Changhua city and county in west Taiwan	Zhang1hua4	unknown

讹传[訛傳]	unfounded rumour; false report	e2chuan2	noun

偏心[偏心]	1 partial; showing particular favour to 她对小儿子有点儿偏心。 Tā duì xiǎo érzi yǒu diǎnr piānxīn. She rather favours her youngest son. or Her youngest son is rather her favourite.; 2 (mechanics) eccentric	pian1xin1	adjective

前揭[前揭]	1 (the item) named above; 2 aforementioned; 3 cited above; 4 op. cit.	qian2jie1	unknown

贮存[貯存]	store; keep in storage	zhu4cun2	verb

报导[報導]	1 report on; 2 information	bao4dao3	unknown

宋太祖[宋太祖]	Emperor Taizu of Song, posthumous title of the founding Song emperor Zhao Kuangyin 赵匡胤 (927-976), reigned from 960	Song4 Tai4zu3	unknown

魏晋[魏晉]	Wei (220-265) and Jin (265-420) dynasties	Wei4 Jin4	unknown

倏[倏]	(literary) suddenly; quickly 羊城一别, 倏已半年。 Yáng chéng yī bié, shū yǐ bàn nián. Six months have passed in a flash since we parted in the City of Rams ( i.e. Guangzhou).	shu1	adverb

历练[歷練]	(literary) verb experience; temper oneself 让孩子出门历练一番。 Ràng háizi chūmén lìliàn yī fān. Let the child go out to see the world. adjective experienced; seasoned 历练老成 lì liàn lǎo chéng be experienced and prudent	li4lian4	unknown, verb, adjective

摩登[摩登]	(transliteration) modern; fashionable 摩登家具 módēng jiāju fashionable furniture	mo2deng1	adjective

苗头[苗頭]	symptom of a trend; suggestion of a new development 要注意不良倾向的苗头。 Yào zhùyì bùliáng qīngxiàng de miáotou. Watch out for symptoms of unhealthy tendencies. 他一看苗头不对, 就溜了。 Tā yī kàn miáotou bùduì, jiù liū le. He slipped off when he saw what was going to happen.	miao2tou5	noun

轸[軫]	1 (archaic) crossboard at the rear of a carriage; 2 carriage; 3 (astronomy) zhen (the last of the twenty-eight constellations (二十八宿) of the celestial sphere, consisting of four stars in Corvus) adjective (literary) sorrowful; distressed 轸悼 zhěndào mourn deeply	zhen3	noun, adjective

留美[留美]	study in the US	liu2Mei3	unknown

肃穆[肅穆]	solemn and quiet; solemn and respectful 纪念会气氛肃穆。 Jìniànhuì qìfēn sùmù. The commemoration meeting was permeated with a solemn atmosphere.	su4mu4	adjective

僧尼[僧尼]	Buddhist monks and nuns	seng1ni2	noun

拂尘[拂塵]	horsetail whisk	fu2chen2	noun

英才[英才]	1 (literary) person of outstanding ability (or superior talents); 2 talent; outstanding ability; wisdom	ying1cai2	noun

痛失[痛失]	1 to suffer the painful loss of (a loved one etc); 2 to miss out on (an opportunity); 3 to fail to gain (victory etc)	tong4shi1	unknown

开吊[開弔]	1 to hold memorial service; 2 to hold a funeral	kai1diao4	unknown

治丧[治喪]	make funeral arrangements; prepare a funeral	zhi4sang1	verb

晦气[晦氣]	unlucky 一脸晦气 yī liǎn huìqi gloomy look that suggests bad luck 碰到这种事真是晦气！ Pèngdào zhèzhǒng shì zhēnshi huìqi! Just my rotten luck!	hui4qi5	adjective

下凡[下凡]	(of gods or immortals) descend to the human world	xia4//fan2	verb

乱世[亂世]	troubled times; turbulent days	luan4shi4	noun

眞[眞]	1 really; 2 truly; 3 indeed; 4 real; 5 true; 6 genuine	zhen1	unknown

纣辛[紂辛]	Zhou Xin (c. 11th century BC), last emperor of the of Shang Dynasty	Zhou4 Xin1	unknown

妲己[妲己]	Da Ji (the favourite concubine of King Zhou (纣王), the last ruler of Shang Dynasty)	Da2ji3	unknown

褒姒[褒姒]	Baosi, concubine of King You of Zhou 周幽王 Zhōu Yōuwáng [周幽王] and one of the famous Chinese beauties	Bao1si4	unknown

八字[八字]	Eight Characters (in four pairs, indicating the year, month, day, and hour of a person's birth, each pair consisting of one Heavenly Stem (天干) and one Earthly Branch (地支), formerly used in fortune-telling) 问八字 wèn bāzì consult one’s horoscope; consult a fortune-teller	ba1zi4	noun

许愿[許願]	1 make a vow (to a god) 烧香许愿 shāoxiāngxǔyuàn burn incense and make vows; 2 promise sb. a reward 我给孩子许了愿, 要是他这次考好了带他去海边玩。 Wǒ gěi háizi xǔ le yuàn, yào shì tā zhècì kǎo hǎo le dài tā qù hǎibiān wán. I promised the child to take him to the seaside if he did well in the exam.	xu3//yuan4	verb

俯[俯]	1 bow (one's head) (opp. 仰) (See fu3shi4 俯视); 2 bend over 俯下身子捡起来 fǔ xià shēnzi jiǎn qǐlai bend down and pick up sth.; 3 (dated) (courteous) [in official documents or letters] condescend to 俯允 fǔyǔn condescend to give permission	fu3	verb

不虞[不虞]	(literary) noun eventuality; contingency 以备不虞 yǐ bèi bùyú prepare for any contingency verb; 1 unexpected (See bu4yu2zhi1yu4 不虞之誉); 2 not worry about 不虞匮乏 bù yú kuìfá fear no shortage of material resources; not worry about running out of supplies	bu4yu2	unknown, verb, noun

机宜[機宜]	principles of action; guidelines 面授机宜 miànshòujīyí brief sb. on how to act	ji1yi2	noun

消灾[消災]	be rid of calamities 消灾免祸 xiāo zāi miǎn huò avert calamities; avoid disasters 祈求神灵消灾降福 Qíqiú shénlíng xiāo zāi jiàng fú pray to the gods to ward off calamities and send down blessings	xiao1//zai1	verb

绫[綾]	(textile) silk fabric finer than satin; damask silk	ling2	noun

飞升[飛昇]	1 to levitate heavenwards (a Daoist success); 2 to take off; 3 to soar (of prices)	fei1sheng1	unknown

禀[稟]	(dated) official report; petition (See bing3tie3 禀帖) verb; 1 (literary) report (to one's superior or senior); petition 回禀 huíbǐng report back (to one’s superior); 2 receive; endowed with (See bing3fu4 禀赋)	bing3	noun, verb

蒐集[蒐集]	1 to gather; 2 to collect	sou1ji2	unknown

丼[丼]	(Tw) bowl of boiled rice with other food on top ((loanword) from Japanese "donburi")	dong4	unknown

底盘[底盤]	chassis (of a car, etc.)	di3pan2	noun

部首[部首]	(linguistics) indexing component (by which characters are arranged in traditional Chinese dictionaries)	bu4shou3	noun

平假名[平假名]	hiragana (one of the written varieties of 假名2, the other being 片假名)	ping2jia3ming2	noun

片假名[片假名]	(linguistics) katakana (one of the written varieties of 假名2, the other being 平假名)	pian4jia3ming2	noun

章节[章節]	chapters and sections	zhang1jie2	noun

单数[單數]	1 odd number (opp. 双数); 2 (linguistics) singular (number)	dan1shu4	noun

复数[複數]	1 (linguistics) plural (number); 2 (mathematics) complex number	fu4shu4	noun

动辄[動輒]	(literary) easily; frequently; at every turn 动辄发怒 Dòngzhé fānù fly into a rage on the slightest provocation; short-tempered; have a short fuse	dong4zhe2	adverb

资遣[資遣]	(literary) dismiss sb. with severance pay	zi1qian3	verb

无中生有[無中生有]	purely fictitious; fabricated; fabricate out of nothing 纯粹是无中生有, 当面造谣。 Chúncuì shì wúzhōngshēngyǒu, dāngmiàn zàoyáo. Nothing but rumours fabricated out of thin air.	wu2zhong1-sheng1you3	idiom

焗[焗]	1 (dialect) steam food in a sealed container 全焗鸡 Quán jú jī whole steamed chicken; 2 apply hair cream (to make it soft and shiny) adjective feel smothered; stifling; oppressive	ju2	verb, adjective

四大名著[四大名著]	the Four Classic Novels of Chinese literature, namely: A Dream of Red Mansions 红楼梦 Hónglóu Mèng [红楼梦], Romance of Three Kingdoms 三国演义 Sānguó Yǎnyì [三国演义], Water Margin 水浒传 Shuǐhǔ Zhuàn [水浒传], Journey to the West 西游记 Xīyóu Jì [西游记]	si4da4ming2zhu4	unknown

霸凌[霸凌]	bullying (loanword)	ba4ling2	unknown

乐土[樂土]	land of happiness; paradise; promised land 人间乐土 rénjiān lètǔ paradise on earth; land of milk and honey 逝将去女, 适彼乐土。(《诗经》) Shì jiāng qù nǚ, shì bǐ lètǔ. (《Shījīng》) At last we are going to leave you, | And go to that happy land.	le4tu3	noun

奔放[奔放]	bold and unrestrained; untrammelled 奔放不羁的风格 bēnfàng bù jī de fēnggé a bold and flowing style 豪爽奔放的性格 Háoshuǎng bēnfàng de xìnggé a forthright and open nature 李白的诗潇洒奔放。 Lǐ Bái de shī xiāosǎ bēnfàng. Li Bai’s poems are known for their free and natural expression.	ben1fang4	adjective

门神[門神]	Door god (whose pictures were often pasted on the front door of a house as a talisman)	men2shen5	noun

底子[底子]	1 bottom; base 鞋底子 xiédǐzi the sole of a shoe; 2 foundation 底子薄 dǐzi báo have a poor foundation 他的英文底子好。 Tā de Yīngwén dǐzi hǎo. He has a good grounding in English.; 3 rough draft or sketch 画画儿要先打个底子。 Huà huàr yào xiān dǎ ge dǐzi. Before drawing a picture, first make a rough sketch.; 4 copy kept as a record; file copy 发出的文件要留个底子。 Fāchū de wénjiàn yào liú ge dǐzi. Keep a copy of each document sent out.; 5 remnant; last of 货底子 huòdǐzi remnants of stock; 6 ground; background; foundation 一件浅灰色底子淡蓝色条子的上衣 yī jiàn qiǎn huīsè dǐzi dànlán sè tiáozi de shàngyī a light grey jacket with pale blue stripes	di3zi5	noun

优盘[優盤]	(computing) flash memory disk; U-disk	you1pan2	noun

声符[聲符]	(linguistics) phonetic element of a Chinese pictophonetic character (e.g. 青 in 情, 清, and 菁)	sheng1fu2	noun

初文[初文]	(archaic) (and simpler) form of a Chinese character	chu1wen2	unknown

领衔主演[領銜主演]	1 leading actors (in a show); 2 starring	ling3xian2zhu3yan3	unknown

合群[合群]	1 get on well with others; be sociable; 2 be gregarious	he2qun2	adjective

避重就轻[避重就輕]	evade major responsibilities and choose minor ones; avoid what's important and dwell on the trivial 对问题避重就轻 Duì wèntí bìzhòngjiùqīng focus on the minor issue	bi4zhong4-jiu4qing1	idiom

浍[澮]	(archaic) ditch in the fields	kuai4	noun

浍[澮]	Hui He River (originating in Henan Province and ending in Anhui Province)	Hui4	noun

肱[肱]	(literary) upper arm; arm 曲肱而枕 qūgōng'érzhěn sleep with one’s head resting on one’s bent arm	gong1	noun

康熙字典[康熙字典]	the Kangxi Dictionary, named after the Kangxi Emperor, who in 1710 ordered its compilation, containing 47,035 single-character entries	Kang1xi1 Zi4dian3	unknown

说文解字[說文解字]	Shuowen Jiezi, the original Han dynasty Chinese character dictionary with 10,516 entries, authored by Xu Shen 许慎 Xǔ Shèn [许慎] in 2nd century	Shuo1wen2 Jie3zi4	unknown

韵母[韻母]	(linguistics) final of a syllable (i.e. the syllable minus the initial 声母, e.g. -iang in 娘 niáng) (The longest form of a final consists of a medial (韵头 or 介音), a head vowel (韵腹), and an ending (韵尾). Thus, in the final -iang of 娘 niáng , -i- is the medial, -a- the head vowel, and -ng the ending. There may be no medial or ending, but there must be at least a head vowel.) (yun4tou2 韵头 yun4tou2)	yun4mu3	noun

浊音[濁音]	(linguistics) voiced sound (opp. 清音)	zhuo2yin1	noun

象形字[象形字]	pictographic character	xiang4xing2zi4	unknown

无止境[無止境]	have no limits; know no end; boundless 母爱永无止境。 mǔ'ài yǒng wúzhǐjìng. A mother’s love is boundless. 科学的发展是无止境的。 Kēxué de fāzhǎn shì wú zhǐjìng de. The development of science has no limits.	wu2zhi3jing4	verb

贪欲[貪慾]	greed; avarice; rapacity	tan1yu4	noun

空中楼阁[空中樓閣]	castles in the air	kong1zhong1-lou2ge2	idiom

一叶障目[一葉障目]	1 lit. eyes obscured by a single leaf (idiom); 2 fig. not seeing the wider picture; 3 can't see the wood for the trees	yi1ye4zhang4mu4	unknown, idiom

百折不挠[百折不撓]	keep trying in spite of all setbacks—undaunted; dauntless; indomitable; unrelenting 百折不挠的努力 Bǎizhébùnáo de nǔlì unrelenting efforts 用百折不挠的毅力去克服所有的困难 yòng bǎizhébùnáo de yìlì qù kèfú suǒyǒu de kùnnan overcome all difficulties with an indomitable will 只要百折不挠地奋斗下去, 最后的胜利必定属于我们。 Zhǐyào bǎizhébùnáo de fèndòu xiàqu, zuìhòu de shènglì bìdìng shǔyú wǒmen. As long as we fight on undaunted, the final victory will be ours.	bai3zhe2-bu4nao2	idiom

刑天[刑天]	Xingtian, headless giant hero of Chinese (mythology) decapitated by the Yellow Emperor 黄帝Huángdì [黄帝]	Xing2tian1	unknown

女娃[女娃]	mythological daughter of Fiery Emperor 炎帝Yándì [炎帝] who turned into bird Jingwei 精卫Jīngwèi [精卫] after drowning	Nü3wa2	unknown

上古[上古]	ancient times; remote ages	shang4gu3	noun

神农[神農]	Sheng Nong, the Holy Farmer (a legendary ruler, the 2nd of the Three August Ones (三皇), supposed to have invented the plough and discovered the curative virtues of plants)	Shen2nong2	noun

神农氏[神農氏]	1 Shennong or Farmer God (c. 2000 BC), first of the legendary Flame Emperors, 炎帝Yándì [炎帝] and creator of agriculture in China; 2 followers or clan of Shennong 神农Shénnóng [神农]	Shen2nong2shi4	unknown

炎帝[炎帝]	Yan Di, also known as Shen Nong (神农), a legendary ruler (See yan2huang2 炎黄;)yan2huang2zi3sun1 炎黄子孙	Yan2di4	noun

精卫填海[精衛填海]	mythical bird jingwei trying to fill up the sea with pebbles—dogged determination; persistent	jing1wei4-tian2hai3	idiom

心中有数[心中有數]	know fairly well	xin1zhong1 you3 shu4	idiom

胸有成竹[胸有成竹]	have a well-thought-out plan, stratagem, etc. 明年的生产计划, 厂长已胸有成竹。 Míngnián de shēngchǎn jìhuà, chǎngzhǎng yǐ xiōngyǒuchéngzhú. The factory director has a well-thought-out plan for next year’s production.	xiong1you3cheng2zhu2	idiom

滥竽充数[濫竽充數]	pass oneself off as one of the players in an ensemble—(of incompetent people or inferior goods) be there just to make up the number; pass off as an expert or a brand name; fill a post without real qualifications	lan4yu2-chong1shu4	idiom

因循守旧[因循守舊]	stick to old ways; follow the beaten track (opp. 破旧立新)	yin1xun2-shou3jiu4	idiom

教条[教條]	1 dogma; doctrine; creed; 2 tenet 教条式的理解 jiàotiáo shì de lǐjiě dogmatic interpretations 马克思主义不是教条。 Mǎkèsīzhǔyì bù shì jiàotiáo. Marxism is not a dogma. adjective dogmatic; opinionated 这个人既教条又狂妄。 zhège rén jì jiàotiáo yòu kuángwàng. The man is opinionated and arrogant.	jiao4tiao2	noun, adjective

韩非子[韓非子]	Han Feizi, book of Legalist Philosophy authored by Han Fei 韩非 Hán Fēi [韩非] during the Warring States Period (475-220 BC)	Han2 Fei1zi3	unknown

智者[智者]	sage; wise person; smart and resourceful person	zhi4zhe3	unknown

史记[史記]	Records of the Historian (by Sima Qian (司马迁) of the Han Dynasty)	Shi3ji4	noun

山海经[山海經]	the Classic of Mountains and Rivers	Shan1hai3jing1	noun

列子[列子]	1 Lie Zi, Daoist author, said to be early Warring States period 战国; 2 Daoist text in eight chapters, said to be by Lie Zi, probably compiled during WeiJin times 魏晋 (3rd century AD)	Lie4zi3	unknown

淮南子[淮南子]	miscellany of writing from the Western Han (aka Former Han)	Huai2nan2zi5	unknown

错综复杂[錯綜複雜]	intricate; complex 小说的情节错综复杂, 引人入胜。 Xiǎoshuō de qíngjié cuòzōngfùzá, yǐnrénrùshèng. The plot of the novel is intricate and fascinating.	cuo4zong1-fu4za2	idiom

谋士[謀士]	adviser; counsellor	mou2shi4	noun

不兴[不興]	1 (colloquial) out of fashion (or style); outmoded 现在不兴中山装了。 Xiànzài bù xīng Zhōngshānzhuāng le. The Chinese tunic suit is out of fashion now.; 2 impermissible; not allowed 不兴这样做。 Bù xīng zhèyàng zuò. That’s not allowed.; 3 [only in a rhetorical question] can't 你干吗嚷嚷, 就不兴小点儿声吗？ Nǐ gànmá rāngrang, jiù bù xīng xiǎo diǎnr shēng ma？ Why shout? Can’t you lower your voice a bit?	bu4xing1	verb

走马看花[走馬看花]	look at flowers while riding a horse—gain a shallow understanding from a fleeting glance; perfunctory and superficial	zou3ma3 kan4 hua1	idiom

瓶颈[瓶頸]	1 bottleneck; neck of a bottle; 2 (figurative) bottleneck; major obstacle 瓶颈式通货膨胀 píngjǐng shì tōnghuò péngzhàng bottleneck inflation 交通瓶颈 jiāotōng píngjǐng traffic bottleneck	ping2jing3	noun

腼腆[靦腆]	shy; bashful 腼腆温柔的少女 miǎntian wēnróu de shàonǚ sweet shy girl 这孩子见了生人有点儿腼腆。 zhè háizi jiàn le shēngrén yǒudiǎnrmiǎntian. The child is shy with strangers.	mian3tian5	adjective

二货[二貨]	1 (slang) fool; 2 dunce; 3 foolishly cute person	er4huo4	unknown

逗比[逗比]	(slang) silly but amusing person	dou4bi1	unknown

马子[馬子]	1 (slang) girl; 2 chick; 3 babe	ma3zi3	unknown

奏效[奏效]	prove effective; successful; get the desired result 这个办法能奏效吗？ Zhège bànfǎ néng zòuxiào ma？ Will this method work? 这药服了马上奏效。 Zhè yào fú le mǎshàng zòuxiào. This (medicine) will have an immediate effect. or This (medicine) works fast. 这个队换用了 4-2-4 阵式, 这一着儿果然奏效。 zhège duì huàn yòng le 4-2-4 zhènshì, zhè yī zhāor guǒrán zòuxiào. The team changed its formation to a 4-2-4 one, which proved effective.	zou4//xiao4	verb

导览[導覽]	1 (visitor, tour, audio etc) guide; 2 guided tour; 3 (site) navigator; 4 to guide	dao3lan3	unknown

酒厂[酒廠]	brewery; winery; distillery	jiu3chang3	noun

长官[長官]	(dated) senior officer (or official); commanding officer	zhang3guan1	noun

拾荒[拾荒]	1 glean a field; glean and collect scraps (to eke out an existence); 2 (figurative) glean information; gather rare material for writing a book, etc.	shi2//huang1	verb

纸[紙]	paper 一张纸 yī zhāng zhǐ a piece (or sheet) of paper Ａ４纸 À zhǐ A4 paper measure word (literary) [for letters, documents, etc.] 一纸公文 yī zhǐ gōngwén a document 单据三纸 dānjù sān zhǐ three bills	zhi3	noun, measure word

材质[材質]	quality of material	cai2zhi4	noun

买椟还珠[買櫝還珠]	keep the glittering casket and give back the pearls—show lack of judgement; make the wrong choice	mai3du2-huan2zhu1	idiom

塑胶[塑膠]	plastic cement	su4jiao1	noun

借指[借指]	1 to refer to; 2 metaphor	jie4zhi3	unknown

俾[俾]	(literary) make; cause; enable 对该项工程应予大力支持, 俾能按期完成。 Duì gāi xiàng gōngchéng yīng yǔ dàlì zhīchí, bǐ néng ànqī wánchéng. We should give this project every support so as to complete it on schedule.	bi3	verb

门可罗雀[門可羅雀]	you can catch sparrows on the doorstep—visitors are few and far between	men2ke3luo2que4	idiom

匡[匡]	1 (literary) rectify; correct 过则匡之 guò zé kuāng zhī correct the error when it occurs; 2 (literary) assist; save 匡我不逮 kuāng wǒ bù dǎi help me to overcome my shortcomings; 3 (colloquial) roughly estimate 匡一匡 kuāng yī kuāng make a guess; give a rough estimate noun (Kuāng) a surname	kuang1	verb, noun

流涎[流涎]	slobber; slaver; drool; salivate	liu2xian2	unknown

太子[太子]	crown prince	tai4zi3	noun

愍[愍]	1 to sympathize; 2 to pity; 3 to feel compassion for	min3	unknown

谏[諫]	surname Jian	Jian4	unknown

毡子[氈子]	felt; felt rug; felt blanket	zhan1zi5	noun

屡[屢]	time and again; repeatedly 屡试屡踬 lǚshìlǚzhì fail at each trial 屡战屡胜 lǚzhànlǚshèng have fought many battles and won every one of them; score one victory after another 屡战屡败(北) lǚ zhàn lǚ bài lose one battle (or game) after another; suffer repeated defeats 屡遭不测 lǚzāobùcè have a series of accidents 屡遭打击 lǚ zāo dǎjī repeatedly came under attack	lü3	adverb

反躬自问[反躬自問]	examine oneself; examine one's conscience	fan3gong1-zi4wen4	idiom

笼统[籠統]	general; sweeping; unclear; vague 笼统地说 lǒngtǒng de shuō generally speaking; in short 笼统地解释一下 lǒngtǒng de jiěshì yīxià explain in generalities 说话笼统 shuōhuà lǒngtǒng be general in one’s statements; speak in general terms 这么说未免太笼统了。 Zhème shuō wèimiǎn tài lǒngtǒng le. That statement is rather too sweeping.	long3tong3	adjective

真空[真空]	1 (physics) vacuum 未尽真空 Wèi jìn zhēnkōng partial vacuum; 2 (figurative) world free from human frailties 我们绝非活在真空中。 Wǒmen juéfēi huó zài zhēnkōng zhōng. We live but in an earthly world.	zhen1kong1	noun

薯[薯]	potato; yam 白薯 báishǔ sweet potato	shu3	noun

盥洗[盥洗]	(literary) wash one's hands and face	guan4xi3	verb

壹[壹]	number one [used as the numeral 一 on cheques, banknotes, etc. to avoid mistakes or alterations]	yi1	unknown

笥[笥]	(literary) bamboo-plaited basket or suitcase	si4	noun

有闲[有閒]	have leisure 有闲阶级 yǒuxián jiējí leisured classes; the idle rich	you3xian2	verb

套交情[套交情]	cultivate a friendship; suck up to 跟某官套交情 Gēn mǒu guān tàojiāoqing cozy up to an official	tao4//jiao1qing5	verb

发夹[髮夾]	hairpin; bobby pin; hairclip; barrette	fa4jia1	noun

吃味[吃味]	1 to be jealous; 2 to envy	chi1wei4	unknown

麻吉[麻吉]	1 (slang) (Tw) close friend; 2 best pal; 3 to get along well; 4 to be tight; 5 congenial	ma2ji2	unknown

歹势[歹勢]	1 excuse me; 2 to be sorry; 3 (Taiwanese, POJ pr. [phái-sè])	dai3shi4	unknown

衰运[衰運]	decline in fortunes	shuai1yun4	unknown

代理权[代理權]	attorneyship; procuration; proxy	dai4li3 quan2	unknown

放晴[放晴]	clear up (after rain) 天一放晴咱们就出门。 tiān yī fàngqíng zánmen jiù chūmén. We’ll start our journey as soon as it clears up.	fang4//qing2	verb

经心[經心]	careful; mindful; conscientious 经心搜集各种资料 jīngxīn sōují gèzhǒng zīliào carefully collect all kinds of data 干什么工作都要经心。 Gàn shénme gōngzuò dōu yào jīng xīn. All work should be done conscientiously. 你看宝玉何尝肯念书？他若一经心, 无有不能的。(《红楼梦》) Nǐ kàn bǎoyù hécháng kěn niànshū？ Tā ruò yījīng xīn, wú yǒu bù néng de. (《Hónglóu Mèng》) Baoyu never showed any inclination to study, yet he’d only to glance at a book to master it.	jing1xin1	adjective

嘉义[嘉義]	Jiayi or Chiayi city and county in west Taiwan	Jia1yi4	unknown

奇异笔[奇異筆]	marker (writing instrument)	qi2yi4bi3	unknown

支系[支系]	branch or subdivision of a family	zhi1xi4	unknown

因纽特人[因紐特人]	Inuit	Yin1niu3te4ren2	unknown

印第安人[印第安人]	American Indian; Native American	Yin4di4an1ren2	unknown

回见[回見]	(colloquial) see you later (or again); cheerio	hui2//jian4	verb

介质[介質]	(physics) medium 工作介质 Gōngzuò jièzhì actuating medium	jie4zhi4	noun

见笑[見笑]	1 laugh at (me or us) 我刚开始学, 您可别见笑。 Wǒ gāng kāishǐ xué, nín kě bié jiànxiào. Now don’t laugh at me. I’m only a beginner.; 2 often self-deprecating incur ridicule (by one's poor performance) 写得不好, 见笑, 见笑。 Xiě de bù hǎo, jiàn xiào, jiàn xiào. Excuse my poor writing.	jian4xiao4	verb

名扬四海[名揚四海]	known far and wide; world-renowned; famous far and wide	ming2yang2si4hai3	idiom

担待[擔待]	1 (colloquial) be magnanimous; be tolerant 他初来乍到, 你多担待些。 tā chūláizhàdào, nǐ duō dāndài xiē. He’s new here. Go easy on him.; 2 bear the responsibility 你放心吧, 一切由我担待。 Nǐ fàngxīn ba, yīqiè yóu wǒ dāndài. Have no fear. I’ll bear all the responsibility.	dan1dai4	verb

不周[不周]	not attentive; thoughtless; inconsiderate 计划不周 Jìhuà bùzhōu not well planned; not planned carefully enough 招待不周 zhāodài bùzhōu not be attentive enough to guests; not look after guests well enough	bu4zhou1	adjective

拜会[拜會]	[often for diplomatic occasions] pay an official call; call on 正式拜会 zhèngshì bàihuì pay (or make) an official call on noun visit; call 告别拜会 gàobié bàihuì farewell call 私人拜会 sīrén bàihuì personal visit; private visit (or call) 礼节性拜会 lǐjié xìng bàihuì courtesy call 事务性拜会 Shìwùxìng bàihuì business call	bai4hui4	verb, noun

夭折[夭折]	1 die young; 2 (figurative) come to a premature end 谈判中途夭折。 Tánpàn zhōngtú yāozhé. The negotiations came to a premature end.	yao1zhe2	verb

短路[短路]	(electricity) short circuit verb; 1 short-circuit 供电线短路了。 Gōng diànxiàn duǎnlù le. The (electricity) supply short-circuited.; 2 (dialect) waylay; hold up	duan3lu4	noun, verb

结拜[結拜]	become sworn brothers or sisters	jie2bai4	verb

互惠互利[互惠互利]	reciprocity and mutual benefit	hu4hui4hu4li4	unknown

冰刀[冰刀]	(sports) (ice) skates	bing1dao1	noun

下文[下文]	1 in the following passage, paragraph, article, etc.; further down (opp. 上文) 下文再作阐述 Xià wén zài zuò chǎnshù explain in the ensuing chapters or paragraphs or further down; 2 later development; outcome; sequel 申请书交上去两个星期了, 还没有下文。 Shēnqǐngshū jiāo shàng qù liǎng ge xīngqī le, hái méiyǒu xiàwén. The application was handed in a couple of weeks ago, but so far there’s been no reply. 事情并没有就此结束, 还有下文哩。 Shìqing bìng méiyǒu jiù cǐ jiéshù, háiyǒu xiàwén li. The matter just didn’t end there, there was more.	xia4wen2	noun

雪藏[雪藏]	1 (dialect) freeze; refrigerate 雪藏果汁 xuěcáng guǒzhī cold fruit juice; 2 (figurative) conceal; keep idle intentionally 教练把主力雪藏起来, 决赛再派上场。 jiàoliàn bǎ zhǔlì xuěcáng qǐlai, juésài zài pài shàngchǎng. The coach kept the top players till the final.; 3 shelve; lay aside 涉毒艺人被雪藏。 Shè dú yìrén bèi xuěcáng. The star involved in drug trafficking was rested.	xue3cang2	verb

郎才女貌[郎才女貌]	a brilliant young scholar and a beautiful woman—a fine couple; a perfect match	lang2cai2-nü3mao4	idiom

下三滥[下三濫]	1 riffraff; 2 scum; 3 lowlife; 4 despicable; 5 inferior	xia4san1lan4	unknown

回绝[回絕]	decline; refuse 一口回绝 yī kǒu huíjué flatly refuse 她婉言回绝了他的邀请。 Tā wǎnyán huíjué le tā de yāoqǐng. She declined his invitation politely.	hui2jue2	verb

杈[杈]	(tree) branch 树杈 shùchà crotch (of a tree)	cha4	noun

杈[杈]	wooden fork; hayfork; pitchfork	cha1	noun

江湖[江湖]	rivers and lakes—all corners of the country; the wide world 流落江湖 liúluòjiānghú live a vagabond life 自叙少小时欢乐事, 今漂沦憔悴, 转徙于江湖间。(白居易《琵琶行》) zìxù shǎo xiǎoshí huānlè shì, jīn piāolún qiáocuì, zhuǎnxǐ yú jiānghú jiān. She told me of the pleasures of her youth and said now that her beauty had faded she was drifting from place to place by rivers and lakes.	jiang1hu2	noun

纸包不住火[紙包不住火]	(well-known phrase) you can't wrap fire in paper—there is no concealing the truth; truth will out	zhi3 bao1bu5zhu4 huo3	unknown

援助交际[援助交際]	Enjo-kōsai or "compensated dating", a practice which originated in Japan where older men give money or luxury gifts to women for their companionship and sexual favors	yuan2zhu4jiao1ji4	unknown

援交[援交]	abbr. for 援助交际yuánzhùjiāojì [援助交际]	yuan2jiao1	unknown

麻子[麻子]	1 pockmarks 他脸上有几点儿麻子。 Tā liǎn shàng yǒu jǐ diǎnrmázi. He’s got a few pockmarks on his face.; 2 person with a pockmarked face	ma2zi5	noun

波霸[波霸]	1 (slang) (loanword) big boobs; 2 big-breasted; 3 (coll.) tapioca balls, in 波霸奶茶bōbànǎichá [波霸奶茶]	bo1ba4	unknown

打包票[打包票]	vouch for; guarantee 我敢打包票, 机器一定准时送到。 Wǒ gǎn dǎ bāopiào, jīqì yīdìng zhǔnshí sòng dào. I guarantee that the machines will be delivered on time. 这件事你可不能给人打包票。 Zhè jiàn shì nǐ kě bù néng gěi rén dǎbāo piào. This is not a matter in which you can vouch for other people. (bao1piao4 包票 bao1piao4)	da3//bao1piao4	verb

酒保[酒保]	(dated) bartender; barkeeper	jiu3bao3	noun

喝挂[喝掛]	1 (coll.) to get drunk; 2 to get hammered	he1gua4	unknown

刺青[刺青]	tattoo 他背上满是刺青。 Tā bèishang mǎnshì cìqīng. His back is covered in tattoos. verb tattoo; have a tattoo done (on) 让人在手臂上刺青 Ràngrén zài shǒubì shàng cìqīng have a tattoo done on one’s arm	ci4qing1	noun, verb

临门[臨門]	1 arrive at the door; be on the doorstep 贵客临门。 Guìkè línmén. A distinguished guest came to the house. 双喜临门。 shuāngxǐ línmén A double blessing has descended upon the house.; 2 at the goal 临门一脚 línményījiǎo (in football) shoot (at the goal) after breaking through the opponent’s defence; go for the goal	lin2men2	verb

释迦[釋迦]	1 Sakya (name of a north Indian tribe); 2 abbr. for 释迦牟尼 Sakyamuni Buddha; 3 sugar apple	shi4jia1	unknown

尾牙[尾牙]	a year-end dinner for employees	wei3ya2	unknown

割礼[割禮]	(religion) circumcision 行割礼 xíng gēlǐ circumcise sb.	ge1li3	noun

葡萄干[葡萄乾]	1 raisin; 2 dried grape	pu2tao5gan1	unknown

上眼睑[上眼瞼]	upper eyelid	shang4yan3jian3	unknown

擘[擘]	1 break off with the fingers 掰玉米 bāi yùmǐ break off corncobs 掰着手指算 bāi zhe shǒuzhǐ suàn count on one’s fingers 把饼掰成两半 Bǎ bǐng bāi chéng liǎng bàn break the cake in two 一分钱掰成两半花 yī fēn qián bāi chéng liǎng bàn huā watch every penny; 2 (dialect) break up (relationship); fall out 他俩结婚才一年就掰了。 Tāliǎ jiéhūn cái yī nián jiù bāi le. They broke up after only one year of marriage.; 3 (dialect) analyse; study; examine 我们把问题掰了一上午, 还是理不清头绪。 Wǒmen bǎ wèntí bāi le yī shàngwǔ, háishi lǐ bùqīng tóuxù. We spent the whole morning going over the problem, but still failed to sort it out.	bai1	verb

擘[擘]	(literary) thumb	bo4	noun

军法[軍法]	military criminal code; military (law) 军法从事 jūnfǎcóngshì punish according to military law	jun1fa3	noun

舍人[舍人]	1 ancient office title; 2 rich and important person	she4ren2	unknown

房玄龄[房玄齡]	Fang Xuanling (579-648), Tang dynasty historian, compiler of History of Jin dynasty 晋书	Fang2 Xuan2ling2	unknown

如坐针毡[如坐針氈]	feel as if sitting on a bed of nails; be on pins and needles; be on tenterhooks	ru2zuo4zhen1zhan1	idiom

囫囵吞枣[囫圇吞棗]	swallow a date whole—gobble down information without digesting it; read without understanding 读这份资料要细嚼慢咽, 不能囫囵吞枣。 Dú zhè fèn zīliào yào xìjiáomànyàn, bùnéng húlúntūnzǎo. You must read the texts carefully, and not gloss over them without properly digesting them.	hu2lun2-tun1zao3	idiom

张僧繇[張僧繇]	Zhang Sengyou (active c. 490-540), one of the Four Great Painters of the Six dynasties 六朝四大家	Zhang1 Seng1you2	unknown

画龙点睛[畫龍點睛]	bring a painted dragon to life by putting in the pupils of its eyes—add the touch that brings a work of art to life; add the finishing touch; add an apt word to clinch the point	hua4long2-dian3jing1	idiom

对牛弹琴[對牛彈琴]	play the lute to a cow—address the wrong audience; talk over sb.'s head	dui4niu2-tan2qin2	idiom

扪心自问[捫心自問]	examine one's conscience; ask oneself 扪心自问, 我从没亏待过你。 ménxīnzìwèn, wǒ cóngméi kuīdài guò nǐ. I have searched my conscience, and believe I have never mistreated you.	men2xin1-zi4wen4	idiom

问心无愧[問心無愧]	feel no qualms upon self-examination; have a clear conscience 这件事我问心无愧。 Zhè jiàn shì wǒ wènxīnwúkuì. I have done nothing to be ashamed of! 你只要问心无愧, 就不必感到不安。 Nǐ zhǐyào wènxīnwúkuì, jiù bùbì gǎndào bù'ān. You have nothing to worry about as long as you have a clear conscience.	wen4xin1-wu2kui4	idiom

心安理得[心安理得]	feel at ease and justified; have an easy conscience; with mind at rest and conscience clear 你能心安理得地把全部责任都推到他一人身上吗？ Nǐ néng xīn'ānlǐdé de bǎ quánbù zérèn dōu tuī dào tā yī rén shēnshang ma？ Can you shift the blame onto him alone with a clear conscience?	xin1an1-li3de2	idiom

光明磊落[光明磊落]	open and aboveboard 他为人光明磊落。 tā wéirén guāngmínglěiluò. He is open and aboveboard with others.	guang1ming2-lei3luo4	idiom

郴州[郴州]	Chenzhou (a city in Hunan Province)	Chen1zhou1	noun

典故[典故]	allusion; (literary) quotation	dian3gu4	noun

杯弓蛇影[杯弓蛇影]	mistake the reflection of a bow in the cup for a snake—beset with imaginary fears; extremely suspicious; jittery	bei1gong1-she2ying3	idiom

义愤[義憤]	righteous (or moral) indignation 激于义愤 jīyúyìfèn be stirred by righteous indignation 满腔义愤 mǎnqiāng yìfèn be filled with indignation	yi4fen4	noun

晋书[晉書]	History of the Jin Dynasty, fifth of the 24 dynastic histories 二十四史 Èrshísì Shǐ [二十四史], compiled under Fang Xuanling 房玄龄 Fáng Xuánlíng [房玄龄] in 648 during Tang Dynasty 唐朝Tángcháo [唐朝], 130 scrolls	Jin4shu1	unknown

报国[報國]	dedicate oneself to the service of one's country 报国无门 bàoguówúmén be denied the opportunity to serve one’s country 以身报国 yǐ shēn bàoguó lay down one’s life for one’s country	bao4//guo2	verb

闻鸡起舞[聞雞起舞]	rise at cock's crow—diligent and self-disciplined	wen2ji1-qi3wu3	idiom

屣[屣]	(literary) shoe 弃之如敝屣 qìzhīrúbìxǐ throw away like a pair of ragged (or shabby, worn-out) shoes; discard	xi3	noun

赵国[趙國]	Zhao, one of the seven states during the Warring States Period of Chinese (history) (475-220 BC)	Zhao4 Guo2	unknown

刘向[劉向]	Liu Xiang (77-6 BC), Han Dynasty scholar and author	Liu2 Xiang4	unknown

叶公好龙[葉公好龍]	Lord Ye's love of dragons —professed love of what one really fears	Ye4gong1-hao4long2	idiom

险要[險要]	strategically located and difficult of access	xian3yao4	adjective

塞翁失马焉知非福[塞翁失馬焉知非福]	1 the old man lost his mare, but it all turned out for the best (idiom); fig. a blessing in disguise; 2 it's an ill wind that blows nobody any good	sai4weng1shi1ma3yan1zhi1fei1fu2	unknown, idiom

盲人摸象[盲人摸象]	a group of blind men trying to describe an elephant, each mistaking the part he touches for the whole animal—mistake a part for the whole; draw conclusions from incomplete data	mang2ren2-mo1xiang4	idiom

韩愈[韓愈]	Han Yu (768-824), Tang dynasty essayist and poet, advocate of the classical writing 古文运动 and neoclassical 复古 movements	Han2 Yu4	unknown

坐井观天[坐井觀天]	look at the sky from the bottom of a well—have a very narrow view; parochial	zuo4jing3-guan1tian1	idiom

心急吃不了热豆腐[心急吃不了熱豆腐]	1 hasty men don't get to eat hot tofu (idiom); 2 one just has to be patient; 3 haste will ruin everything	xin1ji2chi1bu5liao3re4dou4fu5	unknown, idiom

亡羊补牢[亡羊補牢]	mend the fold after the sheep is lost 亡羊补牢, 犹未为晚。 Wángyángbǔláo, yóu wèi wéi wǎn. It is not too late to mend the fold even after the sheep is lost. or It’s never too late to try.	wang2yang2-bu3lao2	idiom

盾牌[盾牌]	1 shield; buckler; pelta; 2 pretext; excuse	dun4pai2	noun

自欺欺人[自欺欺人]	deceive oneself as well as others 完全是自欺欺人之谈 wánquán shì zìqīqīrén zhī tán a gross deception; thoroughly false	zi4qi1-qi1ren2	idiom

掩耳盗铃[掩耳盜鈴]	plug one's ears while stealing a bell—deceive oneself; bury one's head in the sand	yan3er3-dao4ling2	idiom

败露[敗露]	(of a plot, etc.) fall through and be exposed; uncover 败露无遗 bàilù wúyí be exposed as a crook; totally shown up 阴谋终于败露。 Yīnmóu zhōngyú bàilù. The conspiracy was finally brought to light.	bai4lu4	verb

此地无银三百两[此地無銀三百兩]	(well-known phrase) no 300 taels of silver buried here (the sign put up by the man in the folk tale over the place where he had hidden some money)— a clumsy denial resulting in self-exposure 你说这话不是此地无银三百两吗！ nǐ shuō zhè huà bù shì cǐdìwúyínsānbǎiliǎng ma! What you said only gave yourself away.	ci3di4 wu2 yin2 san1bai3 liang3	unknown

朝三暮四[朝三暮四]	blow hot and cold; chop and change; changeable	zhao1san1-mu4si4	idiom

远征军[遠征軍]	expeditionary army (or force)	yuan3zheng1jun1	unknown

战国策[戰國策]	"Strategies of the Warring States", chronicle of the Warring States Period (475-220 BC), possibly written by Su Qin 苏秦 Sū Qín [苏秦]	Zhan4guo2ce4	unknown

本末倒置[本末倒置]	mistake the branch for the root—put the cart before the horse; reverse the proper order; stand things on their head 强调方法而牺牲内容, 无异于本末倒置。 Qiángdiào fāngfǎ ér xīshēng nèiróng, wúyìyú běnmòdàozhì. To emphasize method at the expense of content is to put the cart before the horse.	ben3mo4-dao4zhi4	idiom

舍本逐末[捨本逐末]	attend to trifles and neglect essentials	she3ben3-zhu2mo4	idiom

取舍[取捨]	accept or reject; make one's choice 对技术资料进行分析后决定取舍 Duì jìshù zīliào jìnxíng fēnxi hòu juédìng qǔ-shě analyse all the technical data first and then decide what to use	qu3she3	verb

顿悟[頓悟]	1 (Buddhism) realize the truth suddenly; revelation; 2 [often in a philosophical sense] suddenly realize; sudden enlightenment	dun4wu4	verb

相得益彰[相得益彰]	each shine more brilliantly in the other's company; bring out the best in each other; complement each other	xiang1de2-yi4zhang1	idiom

劝勉[勸勉]	(literary) advise and encourage 互相劝勉 Hùxiāng quànmiǎn help and encourage each other	quan4mian3	verb

吕氏春秋[呂氏春秋]	lit. “Mr. Lü's Spring and Autumn (Annals)”, compendium of the philosophies of the Hundred Schools of Thought 诸子百家zhūzǐbǎijiā [诸子百家], compiled around 239 BC under the patronage of Qin Dynasty 秦代Qíndài [秦代] Chancellor Lü Buwei 吕不韦 Lǚ Bùwéi [吕不韦]	Lü3shi4 Chun1qiu1	unknown

拘泥[拘泥]	be a stickler for (form, etc.); rigidly adhere to (formalities, etc.) 拘泥成说 jūnì chéngshuō rigidly adhere to accepted theories 拘泥于细节 jūnìyú xìjié punctilious; detailed 拘泥于形式 Jūnì yú xíngshì rigidly adhere to form; formalistic adjective VARIANT OF ju1jin3 拘谨 overcautious; reserved	ju1ni4	verb, adjective

变通[變通]	flexible; accommodate (or adapt) sth. to circumstances 变通(的)办法 biàntōng bànfǎ accommodation; adjustment 根据不同情况作适当的变通 gēnjù bùtóng qíngkuàng zuò shìdàng de biàntōng make appropriate adjustments in the light of specific conditions	bian4tong1	verb

侥幸心理[僥倖心理]	1 trusting to luck; 2 wishful thinking	jiao3xing4xin1li3	unknown

桃花运[桃花運]	1 a man's luck in love 走桃花运 zǒu táohuāyùn be lucky in love; have pleasant love affairs; 2 good luck	tao2hua1yun4	noun

攻势[攻勢]	offensive (opp. 守势) 采取攻势 cǎiqǔ gōngshì take the offensive 政治攻势 zhèngzhì gōngshì political offensive 客队攻势凌厉。 Kèduì gōngshì línglì. The visiting team maintained a powerful offensive.	gong1shi4	noun

凌厉[凌厲]	swift and fierce 攻势凌厉 Gōngshì línglì swift and fierce attack 朔风凌厉。 Shuòfēng línglì. A north wind was blowing hard.	ling2li4	adjective

霈[霈]	(literary) noun heavy rain 甘霈 gānpèi timely (or welcome) rain adjective rainy; (of rain) profuse 霈然大雨。 pèi rán dàyǔ. It was raining heavily.	pei4	unknown, adjective, noun

系[系]	1 system; series 语系 yǔxì language family 太阳系 tàiyángxì solar system; 2 department (in a college); faculty 哲学系 zhéxuéxì the department of (philosophy); 3 (geology) system 奥陶系 ào táo xì the Ordovician system	xi4	noun

此致敬礼[此致敬禮]	With best regards.	Ci3zhi4 jing4li3!	unknown

熟络[熟絡]	1 familiar; 2 close	shu2luo4	unknown

礼多人不怪[禮多人不怪]	(well-known phrase) Nobody will blame you for being too polite. or One can never be too courteous. or Nobody is offended by excessive politeness.	li3 duo1 ren2 bu4 guai4	unknown

冗长[冗長]	tediously long; lengthy; long-winded; prolix 冗长的讲演 rǒngcháng de jiǎngyǎn long and tedious speech	rong3chang2	adjective

代班[代班]	1 (Tw) to take over sb's job; 2 to substitute for	dai4ban1	unknown

人资[人資]	abbr. of 人力资源rénlìzīyuán [人力资源]	ren2zi1	unknown

人力资源[人力資源]	human resources	ren2li4 zi1yuan2	unknown

变心[變心]	cease to be faithful; change loyalties; break faith 他变了心, 把女友给甩了。 Tā biàn le xīn, bǎ nǚyǒu gěi shuǎile. He lost interest in his girlfriend and ditched her.	bian4//xin1	verb

龟毛[龜毛]	1 indecisive; 2 fussy; 3 nitpicking (Taiwan dialect)	gui1mao2	unknown

吹毛求疵[吹毛求疵]	find fault with; pick holes in; nitpick 总之, 这是一本好书, 对小处不必吹毛求疵。 Zǒngzhī, zhè shì yī běn hǎo shū, duì xiǎo chù bùbì chuīmáoqiúcī. On the whole it’s a good book; and it would be nitpicking to dwell on those small defects.	chui1mao2-qiu2ci1	idiom

沙龙[沙龍]	salon 文学沙龙 wénxué shālóng (literary) salon 学术沙龙 xuéshù shālóng academic salon	sha1long2	noun

秋葵[秋葵]	1 okra (Hibiscus esculentus); 2 lady's fingers	qiu1kui2	unknown

毛豆[毛豆]	young (or fresh) soya bean	mao2dou4	noun

日耳曼[日耳曼]	Germanic	Ri4er3man4	unknown

作坊[作坊]	workshop 生产纺织品的作坊 shēngchǎn fǎngzhīpǐn de zuōfang (textile) workshop	zuo1fang5	noun

萨尔瓦多[薩爾瓦多]	El Salvador	Sa4er3wa3duo1	unknown

矽胶[矽膠]	1 (Tw) silica gel; 2 silicone rubber	xi1jiao1	unknown

牙套[牙套]	dentistry (orthodontic) braces	ya2tao4	noun

维尼熊[維尼熊]	Winnie the Pooh	Wei2ni2xiong2	unknown

庆典[慶典]	celebration; a ceremony to celebrate 举行盛大的庆典 Jǔxíng shèngdà deqìngdiǎn hold a grand celebration	qing4dian3	noun

双下巴[雙下巴]	double chin	shuang1xia4ba5	noun

惯用语[慣用語]	(linguistics) customary usage; locution; phrase; fixed expression	guan4yong4yu3	unknown

铁轨[鐵軌]	railway track	tie3gui3	unknown

自由女神像[自由女神像]	Statue of Liberty	Zi4you2 Nü3shen2xiang4	unknown

回纹针[迴紋針]	paper clip	hui2wen2zhen1	unknown

侬[儂]	1 (dialect) you; 2 (dated) [used in poems] I; me; my	nong2	pronoun

佛陀[佛陀]	Buddha (a title for Sakyamuni or a person who has attained enlightenment)	Fo2tuo2	noun

非营利[非營利]	nonprofit; nonprofitable	fei1ying2li4	adjective

温顺[溫順]	docile; meek 像小羊一般温顺 xiàng xiǎo yáng yībān wēnshùn as meek as a lamb	wen1shun4	adjective

轴承[軸承]	(mechanics) bearing	zhou2cheng2	noun

散心[散心]	drive away one's cares; relieve boredom	san4//xin1	verb

挂牌[掛牌]	1 hang out one's shingle; put up one'sbrass plate 挂牌行医 guàpái xíngyī have (or open) a medical practice; 2 (economics) (of a company) listed on the stock market; quoted; 3 officially start business (by unveiling its sign); 4 (sports) (of a (sports) club) announce a list of players available for trading; 5 wear a name (or an ID) badge (as required of personnel that provide a public service) 这家超市的售货员必须挂牌上岗。 Zhè jiā chāoshì de shòuhuòyuán bìxū guàpái shànggǎng. Salespeople in this supermarket must wear name badges when on duty.	gua4//pai2	verb, noun

证交所[證交所]	(abbreviation) = zheng4quan4jiao1yi4suo3 证券交易所 stock exchange	zheng4jiao1suo3	noun

压铸[壓鑄]	(metallurgy) die-cast; transfer mould	ya1zhu4	verb

东莞[東莞]	Dongguan (a city in Guangdong Province)	Dong1guan3	unknown

存折[存摺]	1 passbook; 2 bankbook	cun2zhe2	unknown

胭脂[胭脂]	rouge	yan1zhi5	noun

难缠[難纏]	(of a person) unreasonable and hard to deal with; ticklish	nan2chan2	adjective

不足为奇[不足為奇]	not at all surprising; nothing to be surprised at	bu4zu2-wei2qi2	idiom

巷弄[巷弄]	1 alley; 2 lane	xiang4long4	unknown

扩音器[擴音器]	loudhailer; megaphone; loudspeaker; microphone; audio amplifier	kuo4yin1qi4	unknown

九天揽月[九天攬月]	to reach for the stars (idiom)	jiu3tian1lan3yue4	unknown, idiom

婐[婐]	maid	wo3	unknown

麃[麃]	(archaic) a type of deer	pao2	unknown

麃[麃]	to weed	biao1	unknown

刚果[剛果]	the Congo	Gang1guo3	noun

偏差[偏差]	1 deviation; error 认识上的偏差 rènshi shàng de piānchā wrong way of looking at things; an error of judgement 偏差减为一毫米。 Piānchā jiǎn wéi yī háomǐ. The deviation is reduced to one millimetre.; 2 (angle of) deviation; declination	pian1cha1	noun

精进[精進]	1 to forge ahead vigorously; 2 to dedicate oneself to progress	jing1jin4	unknown

胚胎[胚胎]	1 (biology) embryo; 2 (figurative) beginning or rudimentary stage (of anything)	pei1tai1	noun

镌刻[鐫刻]	(literary) engrave; carve	juan1ke4	verb

祖冲之[祖沖之]	Zu Chongzhi (429-500), astronomer and mathematician	Zu3chong1zhi1	unknown

祭拜[祭拜]	to offer sacrifice (to one's ancestors)	ji4bai4	unknown

欹[欹]	(literary) lean to one side; slant; incline	yi1	verb

沁[沁]	1 ooze; seep; exude 他的额上沁出了汗珠。 Tā de é shàng qìn chū le hànzhū. His forehead was oozing sweat.; 2 (dialect) let one's head droop downward; hang 他沁着头。 Tā qìn zhe tóu. He hung (or drooped) his head.; 3 (dialect) put sth. into water	qin4	verb

抠字眼[摳字眼]	to be fastidious about phrasing, diction, or choice of words	kou1zi4yan3	unknown

喵的[喵的]	1 drat; 2 frick; 3 (euphemistic variant of 妈的māde [妈的])	miao1de5	unknown

紧凑[緊湊]	compact; terse; well-knit (opp. 松散) 活动安排得很紧凑 Huódòng ānpái de hěn jǐncòu have a tight schedule 影片情节紧凑。 Yǐngpiàn qíngjié jǐncòu. The film has a well-knit plot. 会议开得很紧凑。 Huìyì kāi de hěn jǐncòu. It was a well-organized meeting. 这个商业区布局紧凑。 zhège shāngyèqū bùjú jǐncòu. The shopping area has a compact layout.	jin3cou4	adjective

苛责[苛責]	criticize severely; excoriate	ke1ze2	verb

往生[往生]	1 to be reborn; 2 to live in paradise (Buddhism); 3 to die; 4 (after) one's death	wang3sheng1	unknown

火龙果[火龍果]	dragon fruit; pitaya; pitahaya	huo3long2guo3	noun

重拾[重拾]	1 to pick up (a theme etc); 2 to regain (confidence); 3 to revive (a custom, friendship etc)	chong2shi2	unknown

居高不下[居高不下]	(of prices, rates etc) to remain high	ju1gao1bu4xia4	unknown

齐头[齊頭]	1 at the same time; 2 simultaneously; 3 (when stating a quantity that is a round number) exactly	qi2tou2	unknown

参差不齐[參差不齊]	uneven; not uniform 学生们的汉语水平参差不齐。 Xuésheng men de Hànyǔ shuǐpíng cēncībùqí. The students have different levels of Chinese proficiency .	cen1ci1-bu4qi2	idiom

找茬[找茬]	1 to pick fault with; 2 to spot the differences; 3 to nitpick; 4 to pick a quarrel; 5 to find complaint with	zhao3cha2	unknown

找碴[找碴]	1 to pick fault with; 2 to spot the differences; 3 to nitpick; 4 to pick a quarrel; 5 to find complaint with	zhao3cha2	unknown

维他命[維他命]	vitamin 维生素 wéishēngsù E E vitamin E 丁种维生素 dīng zhǒng wéishēngsù vitamin D	wei2ta1ming4	noun

当仁不让[當仁不讓]	not decline to shoulder a responsibility; not leave to others what one ought to do oneself; not pass on to others what one is called upon to do	dang1ren2-bu4rang4	idiom

开窍[開竅]	1 have one's ideas straightened out; enlightened 他一听这么说, 就开窍了。 Tā yī tīng zhème shuō, jiù kāiqiào le. He straightened his ideas out as soon as the matter was explained to him.; 2 (of a child) begin to know things; 3 (dialect) open one's eyes; widen one's view (or horizons); broaden one's mind	kai1//qiao4	verb

平行时空[平行時空]	parallel universe	ping2xing2shi2kong1	unknown

并驾齐驱[並駕齊驅]	run neck and neck; keep abreast of sb.; keep pace with sb.; be on a par with sb.	bing4jia4-qi2qu1	idiom

轩轾[軒輊]	(literary) high and low chariots—high or low; good or bad 不分轩轾 bùfēnxuānzhì equally matched; on a par	xuan1zhi4	noun

不分[不分]	1 not divided; 2 irrespective; 3 not distinguishing between	bu4fen1	unknown

到此一游[到此一遊]	1 to travel (somewhere); 2 (vandalism) "was here"	dao4ci3yi1you2	unknown

爱屋及乌[愛屋及烏]	love for a person extends even to the crows on their roof; love me, love my dog; love everything about sb.	ai4wu1-ji2wu1	idiom

人之初，性本善[人之初，性本善]	(well-known phrase) Man is born good.	ren2 zhi1 chu1, xing4 ben3 shan4	unknown

三字经[三字經]	Three Character Classic, 13th century reading primer consisting of Confucian tenets in lines of; 3 characters	San1zi4 Jing1	unknown

已故[已故]	deceased; late 已故地质学家李四光 Yǐgù dìzhìxuéjiā Lǐ Sìguāng the late geologist Li Siguang	yi3gu4	adjective

牵线[牽線]	1 (of a puppet) pull strings; manipulate or control (from behind the scenes); 2 (colloquial) act as go-between 他们俩谈恋爱是我牵的线。 Tāmen liǎ tán liàn'ài shì wǒ qiān de xiàn. I acted as go-between for them to meet and fall in love.	qian1//xian4	verb

硬要[硬要]	1 firmly set on doing sth; 2 to insist on doing; 3 determined in one's course of action	ying4yao4	unknown

岚[嵐]	(literary) haze; vapour; mist 岚烟 lányān mountain mist 岚影湖光 lányǐnghúguāng hazy atmosphere of the mountain and shimmering light of the lake 山岚 shānlán mountain haze 晓岚 xiǎolán morning mists	lan2	noun

放鸟[放鳥]	to stand someone up	fang4niao3	unknown

昱[昱]	(literary) noun sunlight; sunshine verb shine; illuminate	yu4	unknown, verb, noun

号脉[號脈]	(Chinese medicine) feel the pulse 为病人诊脉 wèi bìngrén zhěnmài take the pulse of a patient	hao4mai4	verb

雪花膏[雪花膏]	vanishing cream	xue3hua1gao1	noun

蔻丹[蔻丹]	(transliteration) nail polish (from “Cutex”)	kou4dan1	noun

窑[窯]	1 kiln 石灰窑 shíhuīyáo limekiln; 2 (coal) pit 小煤窑 xiǎoméiyáo small coal pit; 3 cave dwelling; 4 (dialect) brothel	yao2	noun

钏[釧]	surname Chuan	Chuan4	unknown

戏[戲]	alas; alack (See wu1hu1 於戏w)ūhū	hu1	interjection

蒲扇[蒲扇]	cattail leaf fan (made from a whole Chinese fan palm leaf)	pu2shan4	noun

忸怩[忸怩]	blushing; bashful 别这么忸忸怩怩的, 大方些。 bié zhèmeniǔniǔníní de, dàfang xiē. Don’t be shy. Just relax and take it easy. (怩怩 ní)	niu3ni2	adjective

弦子[弦子]	common name for VARIANT OF san1xian2 三弦 noun (music) sanxian (a three-stringed plucked instrument)	xian2zi5	unknown, noun

拉拉[拉拉]	1 lesbian (Internet slang); 2 Labrador retriever	la1la1	unknown

家当[家當]	(colloquial) family belongings; property; possessions 变卖家当 biànmài jiādang sell one’s property 他把剩余的家当装进箱子。 Tā bǎ shèngyú dejiādang zhuāng jìn xiāngzi. He packed his remaining possessions into the trunk.	jia1dang5	noun

打牙祭[打牙祭]	(dialect) have sth. special to eat	da3//ya2ji4	verb

造化[造化]	(literary) noun Creator; Nature; Creation 造化钟神秀, 阴阳割昏晓。(杜甫《登泰山》) zàohuà zhōng shénxiù, yīnyáng gē hūnxiǎo. Here Creation concentrated unearthly glory, | Dark north slope, the sunlit south divide dusk and dawn. 造化赋形, 支体必双, 神理为用, 事不孤立。(刘勰《文心雕龙》) zàohuà fù xíng, zhī tǐ bì shuāng, shén lǐ wéi yòng, shì bù gūlì. Nature, creating living beings, endows them with limbs in pairs. The Divine Reason operates in such a way that nothing stands alone. verb (of Nature or presumed divine force) create; make 夺天地造化之功 duó tiāndì zàohuà zhī gōng rob Heaven and Earth of their creative powers	zao4hua4	unknown, verb, noun

道台[道臺]	(archaic) intendant of a circuit (an administrative division)	dao4tai2	noun

行事历[行事曆]	1 calendar; 2 schedule	xing2shi4li4	unknown

悠悠球[悠悠球]	yo-yo (loanword)	you1you1qiu2	unknown

纨绔[紈絝]	(literary) silk clothes—rich family (ku4 绔 ku4)	wan2ku4	noun

刮痧[刮痧]	(Chinese medicine) popular treatment for sunstroke by scraping the patient's neck, chest or back with a small board	gua1//sha1	verb

怆然[愴然]	(literary) sad; sorrowful 怆然泪下 chuàngránlèixià burst into sorrowful tears	chuang4ran2	adjective

浩然[浩然]	Hào Rán (1932-2008), journalist and proletarian novelist	Hao4 Ran2	unknown

国共内战[國共內戰]	Chinese Civil War, also known as War of Liberation 解放战争 Jiěfàng Zhànzhēng [解放战争]	Guo2 Gong4 Nei4zhan4	unknown

解放战争[解放戰爭]	1 war of liberation; 2 Second Revolutionary Civil War; the Agrarian Revolutionary War (1927-1937)	jie3fang4 zhan4zheng1	noun

五四运动[五四運動]	(history) May 4th Movement of 1919 (an anti-imperialist, anti-feudal, political, and cultural movement influenced by the Russian October Revolution, led by intellectuals with some knowledge of Communist ideology)	Wu3-Si4 Yun4dong4	noun

北伐[北伐]	go on an expedition north-ward noun (abbreviation) the Northern Expedition (1926-1927) (See di4yi1ci4guo2nei4ge2ming4zhan4zheng1 第一次国内革命战争)	Bei3fa2	verb, noun

忧患[憂患]	suffering; misery; hardship 忧患意识 yōuhuàn yìshi awareness of unexpected development; being prepared for unexpected development 忧患余生 yōuhuàn yúshēng person who has known adversity and sorrow 饱经忧患 bǎojīngyōuhuàn have gone through a good deal (See nei4you1wai4huan4 内忧外患)	you1huan4	noun

粜[糶]	(dated) sell (grain) (opp. 籴 dí)	tiao4	verb

鹃[鵑]	cuckoo	juan1	unknown

思旧[思舊]	(literary) think fondly of past times; miss old acquaintances 思旧情绪 sījiù qíngxù nostalgic feelings	si1jiu4	verb

仆[僕]	1 servant (opp. 主) 男仆 nánpú manservant 女仆 nǚpú maid-servant; 2 (archaic) [man's self-deprecating form of address] your humble servant 仆以为 pú yǐwéi my humble view is that	pu2	noun

廖[廖]	a surname	Liao4	noun

比目鱼[比目魚]	flatfish; flounder	bi3mu4yu2	noun

旧人[舊人]	1 former subordinate or fellow worker; former staff; 2 old friend; 3 ex-lover	jiu4ren2	noun

狂欢[狂歡]	revelry; carnival 狂欢节 Kuánghuānjié carnival 狂欢活动 kuánghuān huó·dòng jamboree 狂欢之夜 kuánghuān zhī yè night of revelry 纵情狂欢 zòngqíng kuánghuān indulge in revelry	kuang2huan1	verb

嘉年华[嘉年華]	(transliteration) carnival	jia1nian2hua2	noun

放空[放空]	(of a car, truck, etc.) travel empty (unloaded or without passengers) 回程放空(车) huíchéng fàngkōng returned unloaded	fang4//kong1	verb

贵庚[貴庚]	(dated) (courteous) your honourable age 贵庚多少 (= 请问贵庚)？ guìgēng duōshao ? May I ask your age?	gui4geng1	noun

笋子[筍子]	1 (dialect) bamboo shoot; 2 VARIANT OF sun3tou5 榫头 sǔntou tenon	sun3zi5	noun

顺子[順子]	a straight (poker, mahjong)	shun4zi5	unknown

丙二醇[丙二醇]	1 propylene glycol; 2 propane-1,2-diol C3H6(OH)2	bing3er4chun2	unknown

杠铃[杠鈴]	(sports) barbell 杠铃片 gànglíngpiàn disc (of a barbell)	gang4ling2	noun

打烊[打烊]	(dialect) (of shops) put up the shutters; close for the night 十点了, 该打烊了。 Shí diǎn le, gāi dǎyàng le. It’s ten o’clock; time to call it a day.	da3//yang4	verb

三伏天[三伏天]	1 three fu—three hottest periods of the year (i.e. 初伏, 中伏, and 末伏; altogether 30 or 40 days); 2 VARIANT OF mo4fu2 末伏 a the last (or third) fu—the third hottest period of the year (10 days) b the first day of the last (or third) fu (falling in early or mid-August)	san1fu2tian1	noun

假借[假借]	make use of; in the name of 假借外力 jiǎjiè wàilì make use of outside forces 假借种种名义 jiǎjiè zhǒngzhǒng míngyì under all kinds of guise; seize all kinds of pretexts noun (linguistics) phonetic loan characters; characters adopted to represent homophones, e.g. 裘 qiú (fur) for 求 qiú (entreat) —one of the six categories of Chinese characters (六书)	jia3jie4	verb, noun

哑铃[啞鈴]	(sports) dumbbell	ya3ling2	noun

科系[科系]	department	ke1xi4	unknown

攻读[攻讀]	1 assiduously study; diligently study; 2 specialise in 攻读法律 gōngdú fǎlǜ study (law) 攻读博士学位 gōngdú bóshì xuéwèi study for a doctorate	gong1du2	verb

雏菊[雛菊]	daisy; marguerite	chu2ju2	noun

部落[部落]	tribe 土著部落 tǔzhù bùluò aboriginal tribe; native tribe 原始部落 yuánshǐ bùluò primitive tribe	bu4luo4	noun

中亚[中亞]	Central Asia	Zhong1 Ya4	noun

划时代[劃時代]	marking a new epoch; epoch-making 划时代的宣言 huàshídài de xuānyán epoch-making declaration 具有划时代的意义 jùyǒu huàshídài de yìyì have epoch-making significance	hua4shi2dai4	adjective

斋[齋]	1 vegetarian diet adopted for religious reasons 吃斋 chīzhāi be on a vegetarian diet as a religious observance; 2 (dated) room or building 学生宿舍第三斋 xuésheng sùshè dì-sān zhāi Student Hostel No.; 3 verb; 1 VARIANT OF zhai1jie4 斋戒 abstain from meat, wine, etc. (when offering sacrifices to gods or ancestors); fast; 2 give alms (to a monk)	zhai1	noun, verb

蚵仔煎[蚵仔煎]	oyster omelette (Taiwanese, POJ pr. [ô-á-chian])	e2zi3jian1	unknown

围兜[圍兜]	bib	wei2dou1	unknown

俏皮话[俏皮話]	1 witty remark; witticism; wisecrack; 2 sarcastic remark; 3 VARIANT OF xie1hou4yu3 歇后语 two-part allegorical saying, of which the first part, always stated, is descriptive, while the second part, sometimes unstated, carries the message, e.g. (泥菩萨过河——自身难保) like a clay idol fording a river—hardly able to save oneself (let alone anyone else)	qiao4pi5hua4	noun

嚣张[囂張]	rampant; arrogant; aggressive 嚣张一时 xiāozhāngyīshí run rampant (or wild) for a time 他也太嚣张了。 Tā yě tài xiāozhāng le. He’s really too aggressive.	xiao1zhang1	adjective

撂[撂]	1 (colloquial) put down; leave behind; drop 撂下活儿 liào xià huór drop one’s work; leave one’s work behind 把帘子撂下来。 Bǎ liánzi liàoxia lái. Let down the curtain. 听说有急诊, 医生撂下筷子就走。 Tīngshuō yǒu jízhěn, yīshēng liàoxia kuàizi jiù zǒu. Hearing that there was an emergency case, the doctor put down his chopsticks and left at once. 这事儿一撂就是半个多月。 zhè shìr yī liào jiùshì bàn ge duō yuè. The matter has been shelved for over a fortnight.; 2 throw down; knock down (See liao4dao3 撂倒); 3 throw away; cast aside; abandon 他辞了职, 把这烂摊子全撂给我们了。 Tā cí le zhí, bǎ zhè làntānzi quán liào gěi wǒmen le. He resigned and left us to take care of the awful mess.	liao4	verb

嘹亮[嘹亮]	resonant; loud and clear 歌声嘹亮。 Gēshēng liáoliàng. The singing is loud and clear.	liao2liang4	adjective

梆[梆]	watchman's clapper onomatopoeia rat-tat; rat-a-tat 梆梆梆的敲门声 bāng bāng bāng de qiāo mén shēng a rat-a-tat at the door; a knock at the door verb (dialect) bang; strike with a stick, etc. 拿擀面杖梆他 Ná gǎnmiànzhàng bāng tā bang him with a rolling pin	bang1	noun, verb

一针见血[一針見血]	pierce to the truth with one pertinent remark; hit the nail on the head 他一针见血点出了我们的毛病。 Tā yīzhēnjiànxiě diǎnchū le wǒmen de máobing. He put his finger on our weak spot. 他一针见血地指出, 那个男孩误入歧途, 责任在家长与教师。 Tā yīzhēnjiànxiě de zhǐchū, nà ge nánhái wùrùqítú, zérèn zài jiāzhǎng yǔ jiàoshī. He hit the nail on the head when he said that the boy’s going astray was the fault of his parents and teachers.	yi1zhen1-jian4xie3	idiom

油漆[油漆]	paint 一层油漆 Yī céng yóuqī a coat of paint 油漆未干！ Yóuqī wèi gān! Wet paint! or Fresh paint! verb cover with paint; paint 把大门油漆一下 Bǎ dàmén yóuqī yīxià have the gate painted	you2qi1	noun, verb

笑面虎[笑面虎]	smiling tiger—outwardly kind but inwardly cruel person	xiao4mian4hu3	noun

承蒙[承蒙]	(polite expression) be accorded (a kindness); be granted (a favour) 承蒙照顾, 十分感谢。 Chéngméng zhàogu, shífēn gǎnxiè. I am very grateful to you for your kind treatment. 承蒙热情接待, 不胜荣幸。 Chéngméng rèqíng jiēdài, bù shèng róngxìng. I feel greatly honoured to be given such a warm reception.	cheng2meng2	verb

中意[中意]	to one's liking; take (or catch) the fancy of 这衣服不中我的意。 Zhè yīfu bù zhòng wǒ de yì. This clothing is not to my taste. 她花了一千元买了一件很中意的西服连衣裙。 Tā huā le yīqiān yuán mǎi le yī jiàn hěn zhòngyì de xīfú liányīqún. She paid 1,000 yuan for a dress that had taken her fancy.	zhong4//yi4	verb

贵人多忘事[貴人多忘事]	a person of your eminence has a short memory (said with good-natured sarcasm); important people have short memories 你是“贵人多忘(事)”, 哪能记得我呀？ Nǐ shì “guìrénduōwàng”, nǎnéng jìde wǒ ya? The higher the rank, the shorter the memory. How would you remember me?	gui4ren2 duo1 wang4 shi4	idiom

无地自容[無地自容]	nowhere to hide one's shame; feel too ashamed to show one's face; look for a hole to crawl into	wu2di4-zi4rong2	idiom

蓦然[驀然]	(literary) suddenly 蓦然回首 mòránhuíshǒu suddenly look back 蓦然想起 Mòrán xiǎngqǐ suddenly remember	mo4ran2	adverb

姊姊[姊姊]	1 older sister; 2 Taiwan pr. [jiějie]	zi3zi3	unknown

高就[高就]	(polite expression) move up to a higher position; get promotion 另有高就 lìngyǒugāojiù have landed a better job 听说你要高就了。 tīngshuō nǐ yào gāojiù le. I’ve heard you’re moving up.	gao1jiu4	verb

瑄[瑄]	(archaic) round flat piece of jade for worshiping Heaven	xuan1	noun

芸[蕓]	meaningless bound form 	yun2	unknown

胶带[膠帶]	1 transparent packing tape; adhesive tape; 2 magnetic tape made of plastic; 3 rubberized tape; adhesive tape	jiao1dai4	noun

冈本[岡本]	Okamoto (Japanese surname and place name)	Gang1ben3	unknown

荷包[荷包]	1 small bag (for carrying money and odds and ends); pouch; 2 pocket (in a garment)	he2bao5	noun

接壤[接壤]	(literary) border on; contiguous to; bounded by 法国和瑞士接壤。 Fǎguó hé Ruìshì jiērǎng. France borders on Switzerland.	jie1rang3	verb

桥墩[橋墩]	(bridge) pier	qiao2dun1	noun

前仰后合[前仰後合]	rock (with laughter) 笑得前仰后合 xiào de qián yǎng hòu hé rock (or shake) with laughter; double up with mirth	qian2yang3-hou4he2	idiom

橹[櫓]	scull; sweep 摇橹 yáolǔ scull noun (archaic) big shield	lu3	noun, noun

竹篙[竹篙]	bamboo punt-pole	zhu2 gao1	unknown

缆绳[纜繩]	thick rope; cable; anchor line	lan3sheng2	noun

里脊[裡脊]	tenderloin 糖醋里脊 tángcùlǐji sweet and sour tenderloin	li3ji5	noun

扁柏[扁柏]	(botany) false cypress (Chamaecyparis)	bian3bai3	noun

榕树[榕樹]	1 (botany) small-fruited fig tree; banyan; banian (Ficus)	rong2shu4	noun

话剧[話劇]	modern drama; stage play	hua4ju4	noun

毒瘤[毒瘤]	malignant tumour; cancer	du2liu2	noun

摇橹[搖櫓]	scull	yao2lu3	unknown

蚕茧[蠶繭]	silkworm cocoon	can2jian3	noun

亡命之徒[亡命之徒]	desperado; daredevil	wang2ming4zhi1tu2	unknown

牠[牠]	it 这杯牛奶你喝了它。 Zhè bēi niúnǎi nǐ hē le tā. Drink up this glass of milk. 有个东西在黑影里蹲着, 我也看不清它到底是猫还是狗。 Yǒu ge dōngxi zài hēiyǐng lǐ dūn zhe, wǒ yě kàn bù qīng tā dàodǐ shì māo háishi gǒu. Some animal was crouching in the shadow but I couldn’t make out whether it was a cat or a dog. 这些画报我都看过了, 你把它拿去吧。 Zhèxiē huàbào wǒ dōu kàn guò le, nǐ bǎ tā ná qù ba. I’ve finished with these magazines, you can have them. noun (Tā) a surname	ta1	pronoun, noun

口哨[口哨]	whistle	kou3shao4	unknown

褂[褂]	Chinese-style unlined garment; gown 短褂儿 Duǎn guàr jacket	gua4	noun

散热[散熱]	1 dissipate heat; 2 radiate heat	san4//re4	verb

筋疲力竭[筋疲力竭]	exhausted; played out; worn out; tired out; all in; dead-beat; dog-tired	jin1pi2-li4jie2	idiom

藉[藉]	1 sleeping mat; 2 to placate	jie4	unknown

凉亭[涼亭]	wayside pavilion; kiosk	liang2ting2	noun

青菜[青菜]	vegetables; greens; greenstuff 有机蔬菜 yǒujī shūcài organic vegetable 蔬菜栽培 shūcài zāipéi vegetable growing (or farming)	qing1cai4	noun

脑溢血[腦溢血]	(medicine) cerebral haemorrhage	nao3yi4xue4	noun

伙计[伙計]	1 partner; 2 (colloquial) fellow; mate 伙计, 上哪儿去？ Huǒji, shàng nǎr qù？ Where are you going, mate? 他是我的老伙计。 Tā shì wǒ de lǎo huǒji. He’s an old pal of mine.; 3 (dated) salesman; sales clerk; shop assistant; farm labourer	huo3ji5	noun

偏执[偏執]	immoderate and stubborn 偏执的批评家 piānzhí de pīpíngjiā bigoted critic	pian1zhi2	adjective

下作[下作]	(dialect) assistant; helper 打下作 Dǎxià zuo act as assistant adjective; 1 low-down; mean; obscene 下作胚 xiàzuo pēi lewd; lecher 那个老家伙太下作。 Nàge lǎojiā huǒ tài xiàzuo. That man is a mean old bird.; 2 (dialect) greedy (for food); gluttonous	xia4zuo5	noun, adjective

鞋带[鞋帶]	shoelace; shoestring 系鞋带 jì xiédài do up (or tie) one’s shoelace	xie2dai4	noun

峡湾[峽灣]	geography fiord	xia2wan1	noun

爱沙尼亚[愛沙尼亞]	Estonia	Ai4sha1ni2ya4	unknown

器皿[器皿]	household utensils; containers (esp. for use in the house) 玻璃器皿 bō lí qì mǐn glassware (皿皿 mǐn)	qi4min3	noun

娉[娉]	(literary) beautiful; graceful	ping1	adjective

抽调[抽調]	transfer (personnel or material) 抽调干部支援农业 chōudiào gànbù zhīyuán nóngyè transfer cadres to strengthen the agricultural front 抽调部分兵力向北增援 chōudiào bùfen bīnglì xiàng běi zēngyuán move part of the troops to the north as reinforcements 抽调技术人员支援新厂 chōudiào jìshù rényuán zhīyuán xīn chǎng transfer technical personnel to aid the new plant	chou1diao4	verb

妈祖[媽祖]	Mazu (legendary goddess of the sea mainly worshipped in the coastal areas in southeast China)	Ma1zu3	noun

修女[修女]	nun (of the Roman Catholic and Greek Orthodox churches); sister; conventual 当修女 Dāng xiūnǚ become a nun; enter a convent	xiu1nü3	noun

众生[眾生]	(literary) all living creatures	zhong4sheng1	noun

味精[味精]	monosodium glutamate (MSG); gourmet powder	wei4jing1	noun

阴阳[陰陽]	1 (philosophy) (in Chinese thought) yin and yang (the two opposing principles in nature, the former feminine and negative, the latter masculine and positive); 2 ancient Chinese (astronomy) (esp. the study of the movements of the celestial bodies) 阴阳交错。 yīnyáng jiāocuò The yin and yang forces are opposing but complementary to each other.; 3 occult arts (e.g. astrology, geomancy, etc.); 4 VARIANT OF yin1yang2sheng1 阴阳生 (dated) yin-yang adept (e.g. astrologer, diviner, geomancer, etc.)	yin1yang2	noun

富农[富農]	(history) rich peasant	fu4nong2	noun

体恤[體恤]	understand and sympathize with; show solicitude for 体恤烈士遗孤 Tǐxù lièshì yígū show solicitude for the children of revolutionary martyrs	ti3xu4	verb

君子一言，驷马难追[君子一言，駟馬難追]	What is said can't be retracted. or Live up to one's word.	jun1zi3 yi1 yan2, si4ma3 nan2 zhui1	idiom

美丽岛[美麗島]	Formosa (from Ilha Formosa, "Beautiful Isle", the name given to Taiwan Island by passing Portuguese mariners in 1544)	Mei3li4 Dao3	unknown

连战[連戰]	Lien Chan (1936-), Taiwanese politician, former vice-president and chairman of Guomintang	Lian2 Zhan4	unknown

衬衣[襯衣]	1 underclothes; undergarments; 2 shirt	chen4yi1	noun

占卦[占卦]	divine by means of the Eight Trigrams (八卦)	zhan1//gua4	verb

裴[裴]	a surname	Pei2	noun

深蹲[深蹲]	squat (exercise)	shen1dun1	unknown

越位[越位]	1 (sports) be offside; stand offside 被判越位 bèi pàn yuèwèi be caught (or ruled) offside 前锋没有越位。 qiánfēng méiyǒu yuèwèi. The forward is onside. 裁判判进球无效, 因为有个球员越位。 Cáipàn pàn jìn qiú wúxiào, yīnwèi yǒu ge qiúyuán yuèwèi. The referee disallowed the goal because one of the players was offside.; 2 overstep (or exceed) one's position	yue4//wei4	verb

投放[投放]	1 throw in; put in 投放鱼饵 tóufàng yú'ěr throw in the bait 往井里投放毒药 wǎng jǐng lǐ tóufàng dúyào put poison into a well; 2 put (money) into circulation; put (goods) on the market 新产品已投放市场。 xīnchǎnpǐn yǐ tóufàng shìchǎng. The new product has been put on market.	tou2fang4	verb

头球[頭球]	(sports) header 头球破门 tóuqiúpòmén head the ball into the goal	tou2qiu2	noun

角球[角球]	(sports) (in football, etc.) corner; corner kick 判罚角球 pànfá jiǎoqiú award a corner	jiao3qiu2	noun

罚球[罰球]	(sports) (in basketball) foul shot; free throw; (in football) penalty kick 罚点球 fá diǎn qiú take a spot kick 罚角球 fá jiǎoqiú take a corner kick 罚任意球 fá rènyìqiú take a free kick	fa2//qiu2	verb

发球[發球]	serve a ball 发球得分 fāqiú défēn ace 发球上网 fāqiú shàngwǎng serve and volley 发球不过网 fāqiú bùguò wǎng serve a ball into the net 该谁发球？ Gāi shuí fāqiú？ Whose service is it? 他(的)发球发得好。 Tā fāqiú fā de hǎo. He has a very good serve. or He serves well. 他发了一个怪球。 Tā fā le yī ge guài qiú. He made a tricky serve.	fa1//qiu2	verb

任意球[任意球]	1 (of football) free kick 判给一个任意球 pàngěi yī ge rènyìqiú award sb. a free kick 有争议的任意球 yǒu zhēngyì derènyìqiú disputed free kick; 2 (of hand ball) free throw	ren4yi4qiu2	noun

乌龙球[烏龍球]	(sports) own goal	wu1long2qiu2	noun

搞乌龙[搞烏龍]	1 to mess something up; 2 see also 乌龙球wūlóngqiú [乌龙球]	gao3wu1long2	unknown

鲔[鮪]	1 (archaic) sturgeon; 2 yaito tuna	wei3	noun

寿礼[壽禮]	birthday present (for an elderly person)	shou4li3	noun

大暑[大暑]	1 Greater Heat—the 12th of the 24 solar terms; 2 the day marking the beginning of the 12th solar term (July 22, 23, or 24, in the midst of the three fu (伏) or ten-day periods when the heat is greatest) See SOLAR TERMS	da4shu3	noun

份子[份子]	1 one's share of expenses for a joint undertaking, as in buying a gift for a mutual friend 凑份子 còufènzi club together (to present a gift to sb.); 2 a gift of money	fen4zi5	noun

不肖[不肖]	(literary) (of children) unworthy	bu4xiao4	adjective

一世[一世]	1 all one's life; lifetime 他一世没出过远门。 Tā yī shì méi chū guò yuǎnmén. All his life he’s never been away from home.; 2 age 固一世之雄也, 而今安在哉？(苏轼《前赤壁赋》) Gù yīshì zhī xióng yě, érjīn ānzài zāi? Truly he was the hero of his age, but where is he now?	yi1shi4	noun

风流[風流]	1 refined and tasteful 唐诗如贵介公子, 举止风流。(谢榛《四溟诗话》) Tángshī rú guìjiè gōngzǐ, jǔzhǐ fēngliú. Tang poetry is like a noble prince whose behaviour is refined and tasteful.; 2 unrestrained in spirit and behaviour 吾爱孟夫子, 风流天下闻。(李白《赠孟浩然》) Wú'ài mèng fūzǐ, fēngliú tiānxià wén. I love the Master, Meng Haoran, | A free spirit known the whole world through.; 3 romantic; amorous; licentious 风流才子 fēngliúcáizǐ gallant young scholar 风流寡妇 fēngliú guǎfu merry widow 风流年少 fēngliú niánshào romantic young man	feng1liu2	adjective

丢丑[丟醜]	lose face; disgraced; embarrassed 简直是丢丑！ Jiǎnzhí shì diūchǒu! It’s really a disgrace! or What a disgrace!	diu1//chou3	verb

奔丧[奔喪]	hasten home for the funeral of a parent or grandparent	ben1//sang1	verb

缫丝机[繅絲機]	reeling machine; filature	sao1si1ji1	unknown

狗日[狗日]	1 lit. fucked or spawned by a dog; 2 contemptible; 3 lousy, fucking	gou3ri4	unknown

泼妇[潑婦]	shrew; vixen; virago 泼妇骂街 pōfùmàjiē shout abuse like a shrill housewife	po1fu4	noun

鲢鱼[鰱魚]	silver carp	lian2yu2	unknown

卧推[臥推]	bench press	wo4tui1	unknown

台端[台端]	(dated) (courteous) you [in business letters]	tai2duan1	noun

拖把[拖把]	mop	tuo1ba3	noun

铁匠[鐵匠]	blacksmith; ironsmith	tie3jiang5	noun

弹弓[彈弓]	catapult; slingshot	dan4gong1	noun

藤榻[藤榻]	rattan (or cane) couch	teng2 ta4	unknown

扎猛子[扎猛子]	(dialect) swim with the head submerged; dive	zha1//meng3zi5	verb

倒插门[倒插門]	(colloquial) (of a man) marry into the wife's family 倒插门女婿 dàochā mén nǚxu a live-in son-in-law	dao4cha1men2	verb

混沌[混沌]	Chaos (according to folklore, the primeval state of the universe) 混沌初开 hùndùnchūkāi when earth was first separated from heaven adjective ignorant; simple-minded; muddle-headed 头脑混沌 tóunǎo hùndùn be muddle-headed; stupid	hun4dun4	noun, adjective

话梅[話梅]	preserved plum	hua4mei2	noun

金瓜[金瓜]	1 a kind of pumpkin; 2 a kind of weapon in ancient times	jin1gua1	noun

桥堍[橋堍]	either end of a bridge	qiao2tu4	unknown

膀胱[膀胱]	(urinary) bladder (胱胱 guāng)	pang2guang1	noun

暨[暨]	(literary) verb reach 暨今 jìjīn up till now conjunction and 科技史暨古文献研究所 kējì shǐ jì gǔ wénxiàn yánjiūsuǒ Institute for History of Science and Technology and Ancient Texts	ji4	unknown, verb, conjunction

鲔鱼[鮪魚]	tuna	wei3yu2	unknown

芭乐[芭樂]	guava ((loanword) from Taiwanese)	ba1le4	unknown

气垫[氣墊]	1 air cushion; 2 high-pressure jetting from underneath a hovercraft	qi4dian4	noun

老字号[老字號]	old name in business—long-standing firm (or shop); old and famous enterprise (or shop)	lao3zi4hao5	noun

壁虎[壁虎]	(zoology) gecko; house lizard	bi4hu3	noun

借壳[借殼]	finance borrow (or acquire) a shell 该公司被一家银行借了壳。 Gāi gōngsī bèi yījiā yínháng jiè le ké. The company was acquired as a shell by a bank.	jie4//ke2	verb

倒影[倒影]	inverted image; inverted reflection in water	dao4ying3	noun

诏书[詔書]	imperial edict	zhao4shu1	noun

礼乐[禮樂]	(archaic) protocol and music	li3yue4	noun

砂纸[砂紙]	abrasive paper; sand paper 玻璃砂纸 bōli shāzhǐ glass paper 金刚砂纸 jīngāng shāzhǐ emery paper	sha1zhi3	noun

繭[繭]	callus; callosity 老趼 lǎojiǎn thick callus	jian3	noun

衡量[衡量]	weigh; measure; judge 衡量得失 héngliang déshī weigh up the gains and losses 请你衡量一下这件事该怎么办。 Qǐng nǐ héngliang yīxià zhè jiàn shì gāi zěnme bàn. Will you please consider what to do about it?	heng2liang5	verb

序论[序論]	introduction	xu4lun4	noun

绪论[緒論]	introduction; exordium 绪论作者 xùlùn zuòzhě prefacer	xu4lun4	noun

抛锚[拋錨]	1 drop anchor; cast anchor; 2 (of vehicles) break down 汽车中途抛锚了。 Qìchē zhōngtú pāomáo le. The car broke down on the way.; 3 (dialect) stop midway; suspend	pao1//mao2	verb

洞察力[洞察力]	insight; insightful; discernment; acumen	dong4cha2li4	unknown

残骸[殘骸]	remains (of a person or animal); wreckage (of a building, machine, vehicle, etc.) 飞机残骸 fēijī cánhái the wreckage of a plane	can2hai2	noun

后备箱[後備箱]	1 trunk; 2 boot (of a car)	hou4bei4xiang1	unknown

阮[阮]	1 surname Ruan; 2 small state during the Shang Dynasty (1600-1046 BC) located in the southeast of modern-day Gansu Province	Ruan3	unknown

诸侯[諸侯]	dukes or princes owing loyalty to an emperor; nobles	zhu1hou2	noun

串流[串流]	to stream (online)	chuan4liu2	unknown

角膜[角膜]	(anatomy) cornea	jiao3mo2	noun

半导体[半導體]	semiconductor	ban4dao3ti3	noun

形同陌路[形同陌路]	to be estranged	xing2tong2mo4lu4	unknown

箴言[箴言]	(literary) admonition; exhortation; maxim	zhen1yan2	noun

维系[維係]	hold together; maintain 维系人心 wéixì rénxīn maintain popular morale	wei2xi4	verb

显赫[顯赫]	illustrious; celebrated 显赫的名声 xiǎnhè de míngshēng great renown; well-known 显赫的战功 Xiǎnhè de zhàngōng illustrious war exploits; distinguished war record 显赫一时的殖民帝国 xiǎnhè yīshí de zhímín dìguó the once mighty colonial empire 声势显赫 shēngshì xiǎnhè have a powerful influence	xian3he4	adjective

家世[家世]	(literary) family's social standing; family background	jia1shi4	noun

驼鹿[駝鹿]	(zoology) elk; moose	tuo2lu4	noun

麋鹿[麋鹿]	(zoology) milu; David's deer	mi2lu4	noun

成见[成見]	preconceived idea; prejudice 消除成见 xiāochú chéngjiàn dispel prejudices 对某人成见很深 Duì mǒurén chéngjiàn hěn shēn be deeply prejudiced against sb. 我对他毫无成见。 Wǒ duì tā háowú chéngjiàn. I have no prejudice against him at all.	cheng2jian4	noun

捐弃[捐棄]	(literary) relinquish; abandon 捐弃前嫌 juānqìqiánxián bury old grudges	juan1qi4	verb

新仇旧恨[新仇舊恨]	new hatred piled on old; old scores and new grievances	xin1chou2-jiu4hen4	idiom

尾骨[尾骨]	(anatomy) coccyx; tailbone	wei3gu3	noun

有其父，必有其子[有其父，必有其子]	Like father, like son.	you3 qi2 fu4, bi4 you3 qi2 zi3	idiom

昕[昕]	(archaic) time just before the sun rises; dawn	xin1	noun

炖肉[燉肉]	1 stewed meat; 2 beef stew	dun4rou4	unknown

薏仁[薏仁]	grains of Job's tears plant 薏苡yìyǐ [薏苡]	yi4ren2	unknown

省亲[省親]	(literary) pay a visit to one's parents or elders	xing3qin1	verb

迁葬[遷葬]	move a grave to another place	qian1zang4	verb

成瘾[成癮]	become addicted to 吸毒成瘾 xīdúchéngyǐn become addicted to drugs	cheng2//yin3	verb

美中不足[美中不足]	a blemish in an otherwise perfect thing; a fly in the ointment; blemish that mars beauty; a f(law) in an apparently perfect thing 这本小说很好, 美中不足的是结尾太冗长了。 Zhè běn xiǎoshuō hěn hǎo, měizhōngbùzú de shì jiéwěi tài rǒngcháng le. This is a good novel, except for the long and tedious ending.	mei3zhong1-bu4zu2	idiom

礼让[禮讓]	give precedence to sb. out of courtesy or thoughtfulness 礼让老人 lǐràng lǎo·rén show priority to senior citizens 国际礼让 Guójì lǐràng the comity of nations 中速行驶, 安全礼让。 Zhōng sù xíngshǐ, ānquán lǐràng. Drive at moderate speed; yield right of way for safety’s sake.	li3rang4	verb

以身作则[以身作則]	set a good example with one's own conduct; set an example	yi3shen1-zuo4ze2	idiom

别具[別具]	to have unique (talent, insight etc)	bie2ju4	unknown

天马行空[天馬行空]	a heavenly steed soaring across the skies—a powerful and unconstrained style (of writing, calligraphy, etc.)	tian1ma3-xing2kong1	idiom

归还[歸還]	return; revert (opp. 借用) 向图书馆借书要按时归还。 Xiàng túshūguǎn jiè shū yào ànshí guīhuán. Books borrowed from the library should be returned on time.	gui1huan2	verb

型录[型錄]	product catalog	xing2lu4	unknown

物流[物流]	logistics	wu4liu2	noun

演算[演算]	perform mathematical calculations; calculate; operate	yan3suan4	verb

量子[量子]	(physics) quantum 光量子 guāng liàngzǐ light quantum	liang4zi3	noun

达摩[達摩]	1 Dharma, the teaching of Buddha; 2 Bodhidharma	Da2mo2	unknown

挹[挹]	1 (literary) ladle out; scoop up 挹酒浆 yì jiǔjiāng ladle out wine; 2 pull	yi4	verb

订单[訂單]	order for goods; order form	ding4dan1	noun

奈米[奈米]	1 (Taiwan) nanometer; 2 nano- (prefix meaning "nanoscale")	nai4mi3	unknown

计程车[計程車]	(dialect) taxi	ji4cheng2che1	unknown

陈水扁[陳水扁]	Chen Shui-Bian (1950-), Taiwanese DPP 民进党 politician, president of the Republic of China 2000-2008	Chen2 Shui3bian3	unknown

特赦[特赦]	1 grant a special pardon; 2 grant a special amnesty 特赦战犯 tèshè zhànfàn grant a special amnesty to war criminals	te4she4	verb

涂鸦[塗鴉]	usually self-deprecating poor handwriting; scrawl	tu2ya1	verb

沆瀣一气[沆瀣一氣]	act in collusion with; wallow in the mire with	hang4xie4-yi1qi4	idiom

吃到饱[吃到飽]	all-you-can-eat (buffet) (Tw)	chi1dao4bao3	unknown

封斋[封齋]	1 (Islam) sawm; 2 (Catholicism) Lent	feng1//zhai1	verb

扎根[扎根]	take root 水和阳光充足, 树苗很快就会扎根。 Shuǐ hé yángguāng chōngzú, shùmiáo hěn kuài jiù huì zhāgēn. Saplings take root quickly with plenty of water and sunlight. 扎根于群众之中 Zhāgēn yú qúnzhòng zhīzhōng take root among the masses; rooted in the people	zha1//gen1	verb

皮匠[皮匠]	1 cobbler (See san1ge5chou4pi2jiang4sai4guo4zhu1ge3liang4 三个臭皮匠,) 赛过诸葛亮; 2 tanner	pi2jiang5	noun

高祖[高祖]	1 (paternal) great-great-grandfather; 2 (literary) remote (or earliest) ancestor	gao1zu3	noun

洪武[洪武]	Hongwu (title of the reign (1368-1398) of Zhu Yuanzhang (朱元璋), founder and 1st emperor of the Ming Dynasty, called posthumously Ming Taizu (明太祖))	Hong2wu3	noun

托拉斯[託拉斯]	(economics) trust	tuo1la1si1	noun

皮包公司[皮包公司]	“briefcase company”—inadequately financed company, not credit-worthy; fly-by-night company; bubble company	pi2bao1 gong1si1	unknown

拨冗[撥冗]	(literary) (polite expression) find time in the midst of pressing affairs 务希拨冗出席。 Wù xī bōrǒng chūxí. Your presence is cordially requested.	bo1rong3	verb

阴囊[陰囊]	(anatomy) scrotum; oscheo	yin1nang2	noun

交媾[交媾]	(literary) have sex; (engage in) sexual intercourse; copulation	jiao1gou4	verb

手提[手提]	portable noun; 1 (abbreviation) = shou3ti2dian4hua4 手提电话 handset; mobile phone; 2 (abbreviation) laptop computer; portable computer	shou3ti2	adjective, noun

嘬[嘬]	1 (literary) to gnaw; 2 to eat ravenously	chuai4	unknown

安全期[安全期]	safe period	an1quan2qi1	noun

褒奖[褒獎]	praise and honour; commend and recognition 他的行为应该受到褒奖。 Tā de xíngwéi yīnggāi shòudào bāojiǎng. His deeds deserve praise and recognition.	bao1jiang3	verb

旧金山[舊金山]	San Francisco	Jiu4jin1shan1	noun

倾销[傾銷]	sell goods at a very low price; dump 倾销货物 qīngxiāo huòwù dump goods	qing1xiao1	verb

蓄谋已久[蓄謀已久]	long premeditated	xu4mou2yi3jiu3	unknown

鸦片战争[鴉片戰爭]	(history) Opium Wars (1840-1842, 1856-1860)	Ya1pian4 Zhan4zheng1	noun

耻毛[恥毛]	pubic hair	chi3mao2	unknown

卿[卿]	1 (archaic) minister or high official; 2 an emperor's form of address for a minister; 3 (dated) a term of endearment used between husband and wife or among close friends; 4 (Qīng) a surname	qing1	noun

娘娘[娘娘]	1 [addressing or referring to an empress or an imperial concubine] 正宫娘娘 zhènggōng niángniang emperor’s consort; empress (太监) 万岁爷有旨, 宣贵妃杨娘娘上殿。(洪昇《长生殿》) Wànsuì yé yǒu zhǐ, xuān guìfēi yáng niángniang shàng diàn. (Eunuch speaking) His Majesty orders Lady Yang to approach.; 2 name for certain guardian goddesses 娘娘庙 niángniang miào Temple of the Goddess of Fertility 子孙娘娘 zǐsūn niángniang Our Lady of Many Children; Goddess of Fertility (patroness of marriage and giver of sons)	niang2niang5	noun

烧卖[燒賣]	steamed dumpling with the dough gathered at the top	shao1mai5	noun

嬲[嬲]	1 (literary) tease; 2 pester	niao3	verb

镣铐[鐐銬]	fetters and handcuffs; shackles; irons; chains 戴上镣铐 dài shàng liàokào be shackled; be in chains	liao4kao4	noun

降解[降解]	degradate 生物降解 shēngwùjiàngjiě biological degradation 可降解塑料 kě jiàngjiě sùliào degradable plastics	jiang4jie3	verb

恒星[恆星]	(astronomy) (fixed) star	heng2xing1	noun

星系[星系]	(astronomy) galaxy 总星系 Zǒng xīngxì metagalaxy	xing1xi4	noun

考拉[考拉]	(zoology) koala	kao3la1	noun

雅俗共赏[雅俗共賞]	(of a work of art or literature) appeal to all; suit both refined and popular tastes	ya3su2-gong4shang3	idiom

婧[婧]	1 (of woman) slender; 2 delicate; 3 virtuous	jing4	unknown

钗[釵]	(dated) hairpin 金钗 jīnchāi a gold hairpin	chai1	noun

初来乍到[初來乍到]	have just come; new (to a job or place)	chu1lai2-zha4dao4	idiom

厨子[廚子]	(colloquial) cook	chu2zi5	noun

佼佼者[佼佼者]	outstanding figure; giant among dwarfs	jiao3jiao3zhe3	unknown

克罗地亚[克羅地亞]	Croatia	Ke4luo2di4ya4	unknown

宫崎骏[宮崎駿]	Miyazaki Hayao (1941-), Japanese director	Gong1qi2 Jun4	unknown

粥样硬化[粥樣硬化]	1 atherosclerosis; 2 hardening of the arteries	zhou1yang4ying4hua4	unknown

劳模[勞模]	(abbreviation) = lao2dong4mo2fan4 劳动模范 model worker 劳模大会 láomó dàhuì model worker conference	lao2mo2	noun

痼疾[痼疾]	chronic (or incurable) illness 医学的发达, 使很多所谓痼疾都能治愈。 yīxué de fādá, shǐ hěn duō suǒwèi gùjí dōu néng zhìyù. Advances in medical science have made it possible to cure many so-called incurable diseases.	gu4ji2	noun

瘴[瘴]	miasma	zhang4	noun

彼岸[彼岸]	1 the other side or bank of a river; the opposite shore 大洋彼岸 dàyáng bǐ'àn the opposite shore of the ocean; the other side of the ocean; 2 (Buddhism) Paramita; the realm above life and death; 3 (figurative) ideal realm that one longs for	bi3an4	noun

肩负[肩負]	take on; undertake; shoulder; bear; be entrusted with 肩负重荷 jiānfù zhòng hè bear a heavy burden; shoulder heavy loads 肩负光荣的任务 jiānfù guāngróng de rènwu undertake a glorious task 肩负着全体职工的委托 jiānfù zhe quántǐ zhígōng de wěituō be entrusted with a mission by the whole staff 我们肩负人民的希望。 Wǒmen jiānfù rénmín de xīwàng. The people place their hopes on us.	jian1fu4	verb

赓续[賡續]	(formal) continue	geng1xu4	unknown

一筹莫展[一籌莫展]	can find no way out; be at one's wits' end; be at the end of one's tether	yi1chou2-mo4zhan3	idiom

发芽[發芽]	germinate; sprout 种子还没有发芽。 Zhǒngzi hái méiyǒu fāyá. The seeds haven’t sprouted yet.	fa1//ya2	verb

忘情[忘情]	1 [usu. in the negative] unruffled by emotion; be unmoved; indifferent 不能忘情 bùnéngwàngqíng still emotionally attached; 2 let oneself go; unrestrained; uninhibited 忘情地歌唱 wàngqíng de gēchàng sing lustily without restraint	wang4qing2	verb

清高[清高]	aloof from politics and material pursuits	qing1gao1	adjective

试管婴儿[試管嬰兒]	test-tube baby	shi4guan3ying1er2	unknown

篪[篪]	(archaic) (music) bamboo flute	chi2	noun

忘年交[忘年交]	1 friendship between the generations; 2 good friends despite a great age difference	wang4nian2jiao1	noun

宝可梦[寶可夢]	Pokémon	Bao3ke3meng4	unknown

匹敌[匹敵]	equal to; well matched 双方实力正相匹敌。 shuāngfāng shílì zhèng xiāng pǐdí. The two sides are well matched.	pi3di2	verb

嵩[嵩]	(archaic) (esp. of a mountain) high; lofty	song1	adjective

黔[黔]	abbr. for Guizhou province 贵州Guìzhōu [贵州]	Qian2	unknown

渝[渝]	1 short name for Chongqing 重庆Chóngqìng [重庆]; 2 old name of Jialing river 嘉陵江Jiālíngjiāng [嘉陵江] in Sichuan	Yu2	unknown

鄂[鄂]	1 another name for Hubei Province; 2 (Ào) a surname	E4	noun

湘[湘]	1 (abbreviation) VARIANT OF xiang1jiang1 湘江 Xiang Jiang River (originating in Guangxi and flowing into Dongting Lake (洞庭湖)); 2 another name for Hunan Province	Xiang1	noun

阿胶[阿膠]	Chinese pharmacology E-gelatin (a tonic for nourishing the blood, named after its place of origin, Dong'e County (东阿县) in Shandong Province)	e1jiao1	noun

佚名[佚名]	nameless; anonymous	yi4ming2	adjective

公海[公海]	international waters; high (or open) seas; mare liberum (opp. 领海)	gong1hai3	noun

鹌鹑[鵪鶉]	(ornithology) quail	an1chun5	noun

丰腴[豐腴]	1 (literary) VARIANT OF feng1ying2 丰盈1 (literary) full and round; well-developed; plump; 2 rich and fertile 丰腴的草场 fēngyú de cǎochǎng rich pasture; 3 sumptuous 丰腴的酒席 fēngyú de jiǔxí sumptuous feast	feng1yu2	adjective

舐[舐]	(literary) lick	shi4	verb

英烈[英烈]	(literary) noun; 1 heroic martyr; 2 brilliant achievement adjective heroic; valiant 英烈女子 yīngliè nǚzǐ heroic woman	ying1lie4	unknown, adjective, noun

壁垒[壁壘]	1 rampart; barrier 排除贸易壁垒 páichú màoyì bìlěi remove (or break down) trade barriers 设置关税壁垒 shèzhì guānshuì bìlěi erect a tariff wall; 2 line of division; sharply contrasted objects 壁垒分明 bìlěifēnmíng diametrically opposed; sharply divided 哲学中的两大壁垒 zhéxué zhòngdì liǎng dà bìlěi two rival camps in philosophy; two diametrically opposed philosophical theories	bi4lei3	noun

玮[瑋]	1 (archaic) a kind of jade; 2 (literary) valuable; precious 玮宝 wěibǎo rare treasure	wei3	noun

埤[埤]	(literary) low wall (on a city wall, sometimes with battlements); parapet (堄堄 nì)	pi4	noun

汤匙[湯匙]	tablespoon; soup spoon	tang1chi2	noun

钹[鈸]	(music) cymbals	bo2	noun

咄咄逼人[咄咄逼人]	overbearing; aggressive; pushy 他说话时的神气咄咄逼人。 Tā shuō huà shí de shénqi duōduōbīrén. He spoke in an overbearing manner.	duo1duo1-bi1ren2	idiom, verb

土坯[土坯]	sun-dried mud brick; adobe	tu3pi1	noun

剽窃[剽竊]	plagiarize; lift 成段地剽窃别人的著作 chéngduàn de piāoqiè biéren de zhùzuò lift whole passages from another person’s work	piao1qie4	verb

蒸馏[蒸餾]	distil 拔顶蒸馏 Bá dǐng zhēngliú topping distillation 常压蒸馏 cháng yā zhēngliú atmospheric distillation 真空蒸馏 zhēnkōng zhēngliú vacuum distillation	zheng1liu2	verb

馄饨[餛飩]	wonton; dumpling soup (饨饨 tún)	hun2tun5	noun

重审[重審]	(law) (conduct) a retrial	chong2shen3	verb

重申[重申]	reaffirm; reiterate; restate 重申前令 chóngshēnqiánlìng reaffirm an existing decree 重申党的纪律 chóngshēn dǎng de jìlǜ affirm anew the discipline of the Party 重申我国政府的一贯立场 chóngshēn wǒguó zhèngfǔ de yīguàn lìchǎng reiterate the consistent stand of our government	chong2shen1	verb

离奇[離奇]	strange; odd; fantastic; bizarre 离奇的故事 Líqí de gùshi strange story 离奇的谎言 líqí de huǎngyán fantastic lie 这事儿很离奇。 Zhè shìr hěn líqí. This is a very odd business.	li2qi2	adjective

荒诞[荒誕]	fantastical; absurd; incredible 荒诞的情节 huāngdàn de qíngjié incredible plot 荒诞的想法 Huāngdàn de xiǎngfa fanciful idea	huang1dan4	adjective

数不胜数[數不勝數]	innumerable; incalculable; countless	shu3bu4sheng4shu3	idiom

猥琐[猥瑣]	boorish; uncouth; rude 言语猥琐 yányu wěisuǒ speak rudely 长得很猥琐 Zhǎng de hěn wěisuǒ of wretched appearance	wei3suo3	adjective

缥缈[縹緲]	dimly discernible; misty 缥缈无定 piāomiǎo wúdìng visionary; intangible (See xu1wu2piao1miao3 虚无缥缈) (缈缈 miǎo)	piao1miao3	adjective

伏案[伏案]	bend over or lean over a table 伏案读书 fú'àndúshū bend over one’s desk reading 伏案作画 fú'àn zuòhuà bend over one’s desk painting	fu2an4	verb

虚无[虛無]	(philosophy) nihility; nothingness adjective (of mind, feeling, etc.) empty; void	xu1wu2	noun, adjective

灰烬[灰燼]	ashes 化为灰烬 huàwéi huījìn be reduced to ashes	hui1jin4	noun

包皮[包皮]	1 wrapping; wrapper; 2 (anatomy) prepuce; foreskin	bao1pi2	noun

跳闸[跳閘]	(electricity) trip	tiao4//zha2	verb

霍金[霍金]	1 Hawkins or Hawking; 2 Stephen Hawking (1942-), British physicist and author of A Brief History of Time 时间简史	Huo4jin1	unknown

斯蒂芬[斯蒂芬]	Stephen or Steven (name)	Si1di4fen1	unknown

贸易逆差[貿易逆差]	unfavourable balance of trade	mao4yi4ni4cha1	unknown

就绪[就緒]	in order; ready 一切都已就绪。 Yīqiè dōu yǐ jiùxù. Everything is ready (or in order). 准备工作已经大致就绪。 Zhǔnbèi gōngzuò yǐjing dàzhì jiùxù. The preparations are more or less completed.	jiu4xu4	verb

幌子[幌子]	1 shop sign; signboard; 2 pretence; cover; front 打着“援助”的幌子 Dǎ zhe “yuánzhù” de huǎngzi under the pretence of aid; in the guise of aid 骗人的幌子 piànrén de huǎngzi facade; front	huang3zi5	noun

罹[罹]	(literary) verb suffer from; meet with 罹病 líbìng suffer from a disease; fall ill 罹祸 líhuò suffer misfortune 罹殃 líyāng suffer disaster noun misery; suffering; distress	li2	unknown, verb, noun

赘述[贅述]	give unnecessary details; say more than is needed 不必一一赘述。 Bùbì yīyī zhuìshù. It is unnecessary to go into details.	zhui4shu4	verb

润滑剂[潤滑劑]	1 lubricant; 2 (figurative) person or thing that helps reduce difficulty or conflict; lubricant	run4hua2ji4	noun

归隐[歸隱]	(literary) return to one's hometown and seclude; live in seclusion in the countryside 辞官归隐 Cíguān guīyǐn resign and live in seclusion	gui1yin3	verb

刽子手[劊子手]	1 (archaic) executioner; headsman; 2 (figurative) slaughterer; butcher	gui4zi5shou3	noun

绥靖[綏靖]	pacify; appease	sui2jing4	verb

缉拿[緝拿]	seize; arrest; apprehend 缉拿凶手 Jīná xiōngshǒu apprehend the murderer 已将叛乱分子一一缉拿归案。 Yǐ jiāng pànluàn fènzǐ yīyī jīná guī'àn. All the rebels have been brought to justice.	ji1na2	verb

莘莘学子[莘莘學子]	a great number of disciples; large numbers of students	shen1shen1xue2zi3	unknown

麻疹[麻疹]	measles 出麻疹 chū mázhěn have measles	ma2zhen3	noun

浣熊[浣熊]	(zoology) racoon	huan4xiong2	noun

席位[席位]	seat (at a conference, in a legislative assembly, etc.)	xi2wei4	noun

抗过敏[抗過敏]	be antiallergic	kang4//guo4min3	verb

泥石流[泥石流]	(geology) mud-rock flow; rockslide; mudslide	ni2shi2liu2	noun

耗油量[耗油量]	oil consumption	hao4you2liang4	unknown

码农[碼農]	menial programmer (computing)	ma3nong2	unknown

二维码[二維碼]	1 two-dimensional barcode; 2 QR code	er4wei2ma3	unknown

陶醉[陶醉]	be drunk (with happiness, etc.); revel in 她的歌声使我陶醉。 Tā de gēshēng shǐ wǒ táozuì. Her singing charmed me completely. 我们不能陶醉于已有的成绩。 Wǒmen bùnéng táozuì yú yǐ yǒude chéngjì. We mustn’t let success go to our heads.	tao2zui4	verb

忌讳[忌諱]	1 taboo 犯忌讳 fàn jìhui violate (or break) a taboo; offend a person’s sensitivity; touch a person’s sore spot; 2 (dialect) vinegar verb; 1 avoid as taboo 忌讳不言 jìhui bù yán be silent avoiding superstitious fear 张先生忌讳人家叫他的外号。 zhāng xiānshengjìhui rénjia jiào tā de wàihào. Mr. Zhang resents being called by his nickname.; 2 avoid as harmful; abstain from 得了痢疾忌讳吃生冷油腻。 Déle lìji jìhui chī shēnglěng yóunì. People suffering from dysentery must avoid raw, cold or greasy food.	ji4hui5	noun, verb

湖泊[湖泊]	lakes	hu2po1	noun

妈宝[媽寶]	mama's boy	ma1bao3	unknown

个人所得税[個人所得稅]	personal income tax	ge4ren2 suo3de2shui4	unknown

栎树[櫟樹]	oak tree	li4shu4	unknown

驿传[驛傳]	relay post-horse mail service (in former times)	yi4chuan2	unknown

箱根[箱根]	Hakone, city on the east coast of Japan southwest of Tokyo	Xiang1gen1	unknown

前列腺[前列腺]	(anatomy) prostate (gland)	qian2lie4xian4	noun

转椅[轉椅]	swivel (or revolving) chair	zhuan4yi3	noun

诉诸[訴諸]	(literary) resort to; appeal to 诉诸武力 sùzhū-wǔlì resort to force; appeal to arms	su4zhu1	verb

大阪[大阪]	Osaka (Japan)	Da4ban3	unknown

榻榻米[榻榻米]	(transliteration) tatami	ta4ta4mi3	noun

壁纸[壁紙]	wallpaper	bi4zhi3	noun

橐橐[橐橐]	(onom.) footsteps	tuo2tuo2	unknown

杜鹃[杜鵑]	(ornithology) cuckoo noun (botany) azalea (鹃鹃 juān)	du4juan1	noun, noun

海棠[海棠]	(botany) Chinese flowering crabapple (Malus spectabilis)	hai3tang2	noun

栉比鳞次[櫛比鱗次]	(of buildings) like fish scales and comb teeth; in tight rows 江岸新建的住宅鳞次栉比。 Jiāng'àn xīnjiàn de zhùzhái líncìzhìbǐ. Row upon row of newly built dwelling houses line the waterfront.	zhi4bi3lin2ci4	idiom

照镜子[照鏡子]	1 look at oneself in the mirror; 2 assess oneself	zhao4//jing4zi5	verb

里外里[裡外裡]	1 (dialect) adding the two sums; taken all together 我省了五十块, 家里又寄来五百块, 里外里有五百五十块。 wǒ shěng le wǔshí kuài, jiālǐ yòu jìlái wǔbǎi kuài, lǐwàilǐ yǒu wǔbǎi wǔshí kuài. I’ve saved up 50 yuan, and my family has sent me 500 yuan, so all together I have 550 yuan.; 2 no matter how you figure it out; either way 三个人干五天跟五个人干三天, 里外里是一样的。 Sān gèrén gàn wǔ tiān gēn wǔ gèrén gàn sān tiān, lǐwàilǐ shì yīyàng de. Three people working five days or five people working three days—either way it’s all the same.	li3wai4li3	adverb

块茎[塊莖]	(botany) (stem) tuber	kuai4jing1	noun

国际歌[國際歌]	the Internationale	guo2ji4ge1	noun

财源滚滚[財源滾滾]	profits pour in from all sides	cai2yuan2gun3gun3	unknown

耶和华见证人[耶和華見證人]	Jehovah's Witnesses	Ye1he2hua2 Jian4zheng4ren2	unknown

猛士[猛士]	(literary) brave warrior; valiant fighter	meng3shi4	noun

蛟龙[蛟龍]	flood dragon (a mythical creature capable of invoking storms and floods)	jiao1long2	noun

同济大学[同濟大學]	Tongji University	Tong2ji4 Da4xue2	unknown

跳梁[跳梁]	jump up and down; excessive	tiao4liang2	verb

空袭[空襲]	make an air attack (or raid) 该城遭到空袭。 gāi chéng zāodào kōngxí. The city was attacked from the air.	kong1xi2	verb

玉碎[玉碎]	be like a broken piece of jade—die in glory	yu4sui4	verb

流言蜚语[流言蜚語]	rumours and slanders	liu2yan2-fei1yu3	idiom

听诊器[聽診器]	stethoscope	ting1zhen3qi4	unknown

眸子[眸子]	pupil (of the eye); eye	mou2zi3	noun

瓦斯[瓦斯]	gas 毒瓦斯 dúwǎsī poisonous gas	wa3si1	noun

面庞[面龐]	contours of the face; face 圆圆的面庞 yuányuán de miànpáng round face	mian4pang2	noun

涅[涅]	(archaic) mining alunite verb (literary) dye sth. black	nie4	noun, verb

旅伴[旅伴]	travelling companion; fellow traveller	lü3ban4	noun

够朋友[夠朋友]	(colloquial) deserve to be called a true friend; be a friend indeed 不够朋友 bù gòupéngyou behave not as a friend ought to	gou4//peng2you5	adjective

土木[土木]	building; construction (See da4xing1tu3mu4 大兴土木)	tu3mu4	noun

扁桃[扁桃]	1 common name for almond (tree); 2 (dialect) VARIANT OF pan2tao2 蟠桃1 flat peach	bian3tao2	noun

矜持[矜持]	1 solemn; 2 restrained; reserved 举止矜持 jǔzhǐ jīnchí have a reserved manner	jin1chi2	adjective

迂回[迂迴]	outflank 迂回包抄 yūhuí bāochāo outflank and envelop 向敌人左侧迂回 xiàng dírén zuǒcè yūhuí outflank the enemy on the left adjective circuitous; tortuous; roundabout 迂回其词 yūhuíqící beat around the bush; be circumlocutory (or periphrastic, discursive, meandering) 迂回前进 yūhuí qiánjìn advance by a roundabout route 小溪迂回于田野之中。 xiǎoxī yūhuí yú tiányě zhīzhōng. A stream winds (or twists and turns) across the fields.	yu1hui2	verb, adjective

沉默是金[沉默是金]	Silence is golden. (idiom)	chen2mo4shi4jin1	unknown, idiom

五行[五行]	(philosophy) five elements (metal, wood, water, fire, and earth; believed by the ancients to make up the physical universe, later used in traditional (Chinese medicine) to explain various physiological and pathological phenomena) 五行相生。 wǔxíng xiāngshēng. The five elements originate from each other.	wu3xing2	noun

幕后[幕後]	often (pejorative) behind the scenes; backstage 幕后操纵 Mùhòucāozòng pull strings behind the scenes	mu4hou4	noun

替身[替身]	1 substitute; replacement; stand-in; 2 scapegoat	ti4shen1	noun

帽檐[帽檐]	hat brim	mao4yan2	noun

塞子[塞子]	stopper; plug; spigot; cork	sai1zi5	noun

矣[矣]	auxiliary classical; 1 [at the end of a sentence like 了 le] 悔之晚矣。 Huǐzhīwǎnyǐ. It’s too late for regrets.; 2 [in exclamatory sentences] 毒矣哉！ Dú yǐ zāi! Diabolical! or How ruthless!	yi3	unknown

负荷[負荷]	load (that a person or machine is expected to perform); work load 超负荷 chāofùhè overload 满负荷 mǎn fùhè full-load verb (literary) carry on one's back or shoulder; bear; shoulder 负荷重任 fùhè zhòngrèn shoulder important responsibilities	fu4he4	noun, verb

吊牌[吊牌]	tag	diao4pai2	unknown

细分[細分]	1 subdivision; 2 segmentation	xi4fen1	unknown

宕[宕]	(literary) delay 延宕 yándàng procrastinate	dang4	verb

礁[礁]	reef; rock 礁岩 jiāoyán reef rock 触礁 chùjiāo strike a reef	jiao1	noun

藻[藻]	1 algae; 2 aquatic plants; 3 (literary) embel-lishment 辞藻 cízǎo diction; rhetoric	zao3	noun

蒂[蒂]	base of a fruit 并蒂莲 bìngdìlián twin lotus flowers on one stalk	di4	noun

玟[玟]	veins in jade	wen2	unknown

玟[玟]	(literary) jade-like stone	min2	noun

蒙恩[蒙恩]	to receive favor	meng2en1	unknown

抬头[抬頭]	1 raise one's head 抬头一看 táitóu yī kàn look up; 2 gain ground; look up; rise noun commerce (on receipts, bills, etc.) name of the buyer or payee, or space for filling in such a name verb begin a new line, as a mark of respect, when mentioning the addressee in letters, official correspondence, etc.	tai2//tou2	verb, verb, noun

配额[配額]	quota 出口配额 Chūkǒu pèi'é export quota 进口配额 jìnkǒu pèi'é import quota 全球配额 quán qiú pèi é global quotas	pei4e2	noun

领海[領海]	territorial waters (or sea) (opp. 公海)	ling3hai3	noun

不虞匮乏[不虞匱乏]	fear no shortage of material resources; not worry about running out of supplies	bu4 yu2 kui4fa2	unknown

预卜[預卜]	foretell; foresee; predict 预卜吉凶 Yù bǔ jí-xiōng try to predict good or bad fortune 预卜命运 yùbǔ mìngyùn prophesy fate 结果如何尚难预卜。 Jiéguǒ rúhé shàng nán yù bǔ. The result is hard to foretell.	yu4bu3	verb

显灵[顯靈]	(of a ghost or spirit) make its presence or power felt; manifest	xian3//ling2	verb

衣钵[衣缽]	(Buddhism) cassock and alms bowl; kasaya and patra; monk's mantle and alms bowl (which he hands down to his favourite disciple); legacy 继承衣钵 Jìchéng yībō inherit the mantle of sb.	yi1bo1	noun

打破砂锅问到底[打破砂鍋問到底]	(well-known phrase) insist on getting to the bottom of the matter 这孩子老爱打破砂锅问到底。 Zhè háizi lǎo ài dǎpòshāguōwèndàodǐ. The child always asks why until he knows everything.	da3po4 sha1guo1 wen4 dao4di3	unknown

显而易见[顯而易見]	obviously; evidently; clearly 何以如此, 原因显而易见。 Héyǐ rúcǐ, yuányīn xiǎn'éryìjiàn. The reason why so is quite obvious.	xian3er2yi4jian4	idiom

甘之如饴[甘之如飴]	enjoy sth. bitter as if it were malt sugar—gladly endure hardship	gan1zhi1-ru2yi2	idiom

汐[汐]	tide during the night; night-tide 潮汐 cháoxī the tides	xi1	noun

软骨[軟骨]	(anatomy) cartilage; soft bone	ruan3gu3	noun

鲍鱼[鮑魚]	1 (archaic) salted fish; 2 (ichthyology) abalone	bao4yu2	noun

花心[花心]	(colloquial) MET center of a flower LIT promiscuous; romantic (in love); unfaithful; infidel 花心男人 huāxīn nánren man who falls in love easily; unfaithful man 他心很花。 Tāxīn hěn huā. He frequently changes his lover.	hua1xin1	adjective

花枝[花枝]	1 spray (sprig of a plant with blossoms); 2 squid (on dining menus); 3 (literary) beautiful woman	hua1zhi1	unknown

唇舌[唇舌]	words; argument 费唇舌 fèi chúnshé take a lot of talking (or explaining) 你这是白费唇舌。 Nǐ zhè shì báifèi chúnshé. You are wasting your breath.	chun2she2	noun

绍兴[紹興]	Shaoxing (a city in Zhejiang Province)	Shao4xing1	noun

花雕[花雕]	high-grade Shaoxing (绍兴) wine	hua1diao1	noun

晚香玉[晚香玉]	(botany) tuberose 晚香玉油 wǎnxiāngyù yóu tuberose oil	wan3xiang1yu4	noun

坠子[墜子]	1 (dialect) weight; plummet; pendant; 2 ear pendant noun; 1 VARIANT OF zhui4qin2 坠琴 (music) zhuiqin; urheen (a kind of bowed instrument); 2 folk art ballad singing to the accompaniment of the zhuiqin (坠琴), popular in Henan Province	zhui4zi5	noun, noun

银耳[銀耳]	tremella (Tremella fuciformis)	yin2er3	noun

戚[戚]	surname Qi	Qi1	unknown

风湿症[風濕症]	rheumatism; rheumatic disease	feng1shi1zheng4	unknown

郁金香[鬱金香]	(botany) tulip (Tulipa gesneriana)	yu4jin1xiang1	noun

簪[簪]	hairpin 碧玉簪 bì yùzān jade hairpin verb wear in one's hair 簪花 zānhuā wear flowers in one’s hair	zan1	noun, verb

公馆[公館]	(dated) residence (of the rich or prominent); mansion 周公馆 zhōu gōng guǎn The Zhou residence	gong1guan3	noun

钜子[鉅子]	1 tycoon; 2 magnate	ju4zi3	unknown

实业[實業]	industry and commerce; enterprise; business	shi2ye4	noun

寸头[寸頭]	crew cut 留寸头 Liú cùn tóu wear a crew cut 我要理个寸头。 Wǒ yào lǐ ge cùn tóu. I want my hair cropped short.	cun4tou2	noun

周遭[週遭]	surrounding area 周遭静悄悄的, 不见一个人。 zhōuzāo jìngqiāoqiāo de, bùjiàn yī gèrén. It was very quiet all around with nobody in sight. 山围故国周遭在, 潮打空城寂寞回。(刘禹锡《石头城》) Shān wéi gùguó zhōuzāo zài, cháo dǎ kōngchéng jìmò huí. Hills surround the ancient kingdom; they never change. | The tide beats against the empty city, and silently, silently returns.	zhou1zao1	noun

厝[厝]	1 (literary) lay; place; 2 place a coffin in a temporary shelter pending burial noun (dialect) house; building	cuo4	verb, noun

雅房[雅房]	1 apartment (with shared bathroom and kitchen); 2 bedsit	ya3fang2	unknown

坪[坪]	level ground 草坪 cǎopíng lawn 停机坪 tíngjīpíng aircraft parking area; parking apron measure word ping (unit of area used in Japan, Hong Kong, Taiwan, etc., roughly equal to 3.3 square metres)	ping2	noun, measure word

稀罕[稀罕]	rare; scarce; uncommon 骆驼在南方是稀罕的东西。 Luòtuo zài nánfāng shì xīhan de dōngxi. Camels are a rare sight in the south. verb value as a rarity; cherish 你看不上, 我还稀罕呢。 Nǐ kànbushàng, wǒ hái xīhan ne. You may not care, but I do. 谁稀罕你的臭钱？ Shuí xīhan nǐ de chòuqián? Who cares about your lousy money? noun novelty; rarity 看稀罕儿 kàn xīhan r watch a novelty; curious 这么大的人参可是个稀罕儿。 zhème dà de rénshēn kěshì ge xīhan r. Such a big ginseng root is certainly a rarity.	xi1han5	adjective, verb, noun

黑死病[黑死病]	plague; Black Death	hei1si3bing4	noun

强弩之末[強弩之末]	an arrow at the end of its flight—a spent force 强弩之末, 力不能入鲁缟。(《汉书》) qiángnǔzhīmò, lì bù néng rù lǔ gǎo. (《Hànshū》) When the arrow is spent, it cannot break fine silk.	qiang2nu3zhi1mo4	idiom

职守[職守]	post; duty 忠于职守 zhōngyúzhíshǒu faithfully discharge one’s duties; fulfill one’s duty	zhi2shou3	noun

瘀青[瘀青]	1 bruise; 2 contusion	yu1qing1	unknown

前戏[前戲]	foreplay	qian2xi4	unknown

平辈[平輩]	persons of the same generation	ping2bei4	noun

击掌[擊掌]	1 clap (one's hands); applaud 击掌为号 jīzhǎngwéihào signal by clapping hands; 2 strike sb.'s palms with one's own (to make a vow) 击掌为盟 jīzhǎng wéi méng clap each other’s hands to vow alliance	ji1//zhang3	verb

护贝[護貝]	(stationery) to laminate (Tw)	hu4bei4	unknown

色香味俱全[色香味俱全]	to smell, look and taste great	se4xiang1wei4ju4quan2	unknown

俱全[俱全]	(literary) complete; entire 店里商品俱全。 diàn lǐ shāngpǐn jùquán. The store stocks everything.	ju4quan2	adjective

色相[色相]	1 (usu. of a woman) sexual charms; sexual appeal 出卖色相 Chūmài sèxiàng sell one’s charms; 2 colours of the spectrum—red, orange, yellow, green, blue, indigo, and violet; 3 (Buddhism) form and aspect	se4xiang4	noun

撇步[撇步]	1 trick (of the trade); 2 clever move; 3 (Taiwanese, POJ pr. [phiat-pōo])	pie1bu4	unknown

显学[顯學]	1 (literary) famous theory or school of thought; 2 field of research that draws much attention; popular subject	xian3xue2	noun

乳糜泻[乳糜瀉]	celiac disease	ru3mi2xie4	unknown

焉知[焉知]	(literary) how is one to know?	yan1zhi1	unknown

黄鳝[黃鱔]	(zoology) ricefield eel; finless eel	huang2shan4	noun

龙虎斗[龍虎鬥]	the dragon fights the tiger—be well matched; be equal in strength noun foodstuffs Longhudou (name of a dish)	long2hu3dou4	idiom, noun

无独有偶[無獨有偶]	usually (pejorative) rare but not unique	wu2du2-you3ou3	idiom

渲染[渲染]	1 Chinese painting add washes of ink or colour to a drawing; 2 play up; exaggerate; dramatize; pile it on 渲染战争的恐怖 xuànrǎn zhànzhēng de kǒngbù play up the horrors of war 一件小事情, 用不着这么渲染。 Yī jiàn xiǎo shìqing, yòngbuzháo zhème xuànrǎn. No need to exaggerate a trifling matter like that. 轻快的舞蹈给这场戏渲染了欢乐气氛。 Qīngkuài de wǔdǎo gěi zhè chǎng xì xuànrǎn le huānlè qìfēn. The lively dance heightened the joyous atmosphere of the scene.	xuan4ran3	verb

躺枪[躺槍]	1 (Internet slang) to get unjustly ridiculed, attacked, implicated in sth etc while just being present; 2 abbr. for 躺着也中枪tǎngzheyězhòngqiāng [躺着也中枪]	tang3qiang1	unknown

充斥[充斥]	(pejorative) flood; congest; be full of 市场上一度充斥着劣质商品。 Shìchǎng shàng yīdù chōngchì zhe lièzhì shāngpǐn. The markets were flooded with shoddy goods.	chong1chi4	verb

臆测[臆測]	conjecture; surmise; guess	yi4ce4	verb

炒作[炒作]	1 hype sth. up; sensationalize 大肆炒作 dàsì chǎozuò excessive, exaggerated publicity; 2 speculate in (stocks, e.g.)	chao3zuo4	verb

不计[不計]	disregard; not take into account 不计报酬 bù jì bàochou not consider remuneration; regardless (or irrespective) of pay 不计成败 bù jì chéng bài indifferent to success or failure; irrespective of success or failure 不计个人得失 Bù jì gèrén dé-shī disregard personal gain or loss	bu4ji4	verb

八面玲珑[八面玲瓏]	usually (pejorative) smooth and slick (in making social contacts) 他这个人八面玲珑, 谁也不得罪。 tā zhège rén bāmiànlínglóng, shuí yě bùdé zuì. He is a very smooth character and never offends anyone.	ba1mian4-ling2long2	idiom

看低[看低]	(colloquial) look down on; belittle; underestimate; underrate; undervalue (opp. 看高)	kan4di1	verb

卖弄[賣弄]	show off; parade 卖弄风骚 màinong fēngsāo play the coquette; flirtatious 卖弄学问 Màinong xuéwen show off one’s learning; parade one’s knowledge 卖弄小聪明 màinong xiǎocōngming try to be smart; smart aleck	mai4nong5	verb

聒噪[聒噪]	(dialect) noisy; clamorous	guo1zao4	adjective

御用[御用]	1 for the use of the emperor; 2 served as a tool; be in the pay of 御用报刊 Yùyòng bàokān hired (or controlled, paid) press	yu4yong4	adjective

铁磁[鐵磁]	(physics) ferromagnetic	tie3ci2	noun

恒温[恆溫]	constant temperature	heng2wen1	noun

味蕾[味蕾]	(anatomy) taste bud	wei4lei3	noun

变声[變聲]	change of voice (at puberty); break	bian4//sheng1	verb

远航[遠航]	take an oceangoing voyage 扬帆远航 yángfān yuǎnháng sail to a distant place	yuan3hang2	verb

奋进[奮進]	advance bravely; go forward courageously 催人奋进 cuī rén fènjìn encourage sb. to progress bravely	fen4jin4	verb

勤则不匮[勤則不匱]	If one is industrious, one will not be in want. (idiom)	qin2ze2bu4kui4	unknown, idiom

革故鼎新[革故鼎新]	discard the old and introduce the new	ge2gu4-ding3xin1	idiom

闽南[閩南]	Minnan (southern Fujian)	Min3nan2	unknown

