缅怀[緬懷]	(literary) cherish the memory of; recall 缅怀故人 miǎnhuái gùrén recall old friends 缅怀往事 miǎnhuái wǎngshì recall past events 缅怀先辈 miǎnhuái xiānbèi cherish the memory of one’s forefathers	mian3huai2	verb

羊驼[羊駝]	(zoology) alpaca (Lama alpacos)	yang2tuo2	noun

懿[懿]	(literary) (esp. of a woman) virtuous; exemplary 懿德 yìdé moral excellence 懿行 yìxíng exemplary conduct	yi4	adjective

麤[麤]	1 coarse; crude; rough (opp. 细) 粗沙 cūshā coarse sand; grit 粗黑的手 cū hēi de shǒu rough, work-soiled hands 这个活儿太粗了。 Zhège huór tài cū le. This is too slovenly a piece of work.; 2 gruff; husky 粗嗓子 Cū sǎngzi husky voice 粗声大气 cū shēng dàqì a deep, gruff voice; 3 careless; negligent 这人心太粗。 Zhè rénxīn tài cū. This guy is too careless.; 4 rude; unrefined; (vulgar) 说话很粗 shuōhuà hěn cū speak rudely; use coarse language; 5 wide (in diameter); thick (opp. 细) 一条粗绳 Yī tiáo cū shéng a thick rope 这棵树很粗。 Zhè kē shù hěn cū. This tree has a thick trunk. adverb roughly; slightly 粗知一二 cūzhīyī'èr have a rough idea; know a little	cu1	adjective, verb, adverb

骉[驫]	(archaic) galloping horses	biao1	noun

睾酮[睾酮]	1 testosterone; 2 abbr. for 睾丸甾酮gāowánzāitóng [睾丸甾酮]	gao1tong2	unknown

珠峰[珠峰]	1 abbr. for 珠穆朗玛峰, Mt Chomolungma or Qomolangma (Tibetan); 2 Mt Everest; 3 Nepalese: Sagarmatha	Zhu1feng1	unknown

窗口[窗口]	1 window 坐在窗口 zuò zài chuāngkǒu sit at (or by) the window 在对外开放中发挥窗口作用 Zài duìwài kāifàng zhōng fāhuī chuāngkǒu zuòyòng serve as a window to the outside world 去上海的火车票在那个窗口卖。 Qù Shànghǎi de huǒchēpiào zài nàge chuāngkǒu mài. Train tickets to Shanghai are sold at that window. 这个电视节目已成为人们了解世界的窗口。 zhège diànshì jiémù yǐ chéngwéi rénmen liǎojiě shìjiè dechuāngkǒu. The TV programme has turned out to be a window on the world.; 2 (computing) window 关闭一个浏览器窗口 Guānbì yī ge liúlǎnqì chuāngkǒu close an IE window	chuang1kou3	noun

鸿猷[鴻猷]	great plan	hong2 you2	unknown

轸念[軫念]	(literary) sorrowfully cherish the memory of; think anxiously about 殊深轸念 shūshēnzhěnniàn express great solicitude for	zhen3nian4	verb

挽联[輓聯]	elegiac couplet	wan3lian2	noun

吊唁[弔唁]	1 to offer condolences (for the deceased); 2 to condole	diao4yan4	unknown

超音速[超音速]	supersonic speed	chao1yin1su4	noun

统一战线[統一戰線]	united front	tong3yi1 zhan4xian4	noun

宥[宥]	(literary) excuse; pardon; forgive 尚希见宥。 Shàngxī jiàn yòu. Please accept my apologies.	you4	verb

执事[執事]	1 to perform one's job; 2 attendant; 3 job; 4 duties; 5 (respectful appellation for the addressee) you; 6 your Excellency; 7 (Church) deacon	zhi2shi4	unknown

砚台[硯臺]	inkstone; inkslab	yan4tai5	noun

横额[橫額]	1 inscribed horizontal board; 2 horizontal scroll bearing an inscription (usu. hung over a door and flanked by two vertical scrolls forming a couplet)	heng2e2	noun

哔叽[嗶嘰]	(textile) serge; twill	bi4ji1	noun

藏青[藏青]	dark blue	zang4qing1	adjective

肃立[肅立]	stand as a mark of respect 肃立默哀 sùlìmò'āi stand in silent mourning 奏国歌时全场肃立。 Zòu guógē shí quánchǎng sùlì. All stood as the band struck up the national anthem. or Everyone stood when the national anthem was played.	su4li4	verb

钢盔[鋼盔]	(steel) helmet	gang1kui1	noun

冷峭[冷峭]	1 (literary) bitterly (or severely) cold 冷峭的风 lěngqiào de fēng chilly wind; 2 sarcastic; caustic 冷峭的话 lěngqiào dehuà tart remarks 性情冷峭 xìngqíng lěngqiào have a sullen temper	leng3qiao4	adjective

阴霾[陰霾]	(literary) usually (figurative) haze; cloudiness 生活在贫困的阴霾下 Shēnghuó zài pínkùn deyīnmái xià live under the shadow of poverty	yin1mai2	noun

撷取[擷取]	1 to pick; 2 to select; 3 to take; 4 to capture (data); 5 to acquire; 6 to pick up (a signal)	xie2qu3	unknown

蝎子[蠍子]	scorpion	xie1zi5	unknown

弹簧[彈簧]	(metal) spring 保险弹簧 bǎoxiǎn tánhuáng relief spring 回动弹簧 huí dòng tánhuáng return spring	tan2huang2	noun

法统[法統]	(dated) legally constituted authority	fa3tong3	noun

不吝[不吝]	(literary) (polite expression) [asking advice] not stint; not grudge; generous with 尚希不吝指教(=赐教)。 Shàngxī bùlìn zhǐjiào. We hope that you will not spare your comments. or We hope that you will not stint your criticism.	bu4lin4	verb

触摸[觸摸]	touch; feel 请勿触摸展品。 Qǐngwù chùmō zhǎnpǐn. Please don’t touch the exhibits.	chu4mo1	verb

届时[屆時]	(literary) when the time comes; at the appointed time; on the occasion 届时务请出席。 Jiè shíwù qǐng chūxí. Your presence is requested for the occasion. 大桥下月竣工, 届时将举行通车典礼。 Dà qiáo xiàyuè jùngōng, jièshí jiāng jǔxíng tōngchē diǎnlǐ. There will be first crossing ceremony next month when the bridge is completed.	jie4shi2	adverb

花花公子[花花公子]	playboy; dandy; coxcomb; fop	hua1hua1-gong1zi3	idiom

捉弄[捉弄]	tease; make fun of; play tricks on	zhuo1nong4	verb

陶冶[陶冶]	1 make pottery and smelt metal; 2 exert a favourable influence (on a person's character, etc.); mould 陶冶情操 táoyěqíngcāo cultivate one’s taste 陶冶性情 táoyě xìngqíng mould a person’s temperament; nurture character	tao2ye3	verb

无可奉告[無可奉告]	no comment	wu2ke3-feng4gao4	idiom

括弧[括弧]	1 parentheses (()); 2 VARIANT OF kuo4hao4 括号2 brackets; parentheses ((),[ ],,【 】, etc., used as punctuation)/	kuo4hu2	noun

神州[神州]	Divine Land (a poetic name for China) 春风杨柳万千条, 六亿神州尽舜尧。(毛泽东) Chūnfēng yángliǔ wànqiān tiáo, liùyì Shénzhōu jìn Shùn Yáo. (Máo Zédōng) The spring wind blowing amid profuse willow wands, | Six hundred million in this Divine Land all Yaos and Shuns.	Shen2zhou1	noun

九州[九州]	1 nine divisions of China in remote antiquity; 2 poetic name for China 九州生气恃风雷。(龚自珍《己亥杂诗》) Jiǔzhōu shēngqì shì fēngléi. Only in wind and thunder can the country show its vitality.; 3 Kyushu (Japanese island)	Jiu3zhou1	noun

抚恤[撫卹]	(of an organization that has a duty of care) to give financial support to relatives of sb who has died or suffered serious injury	fu3xu4	unknown

戳[戳]	1 jab; poke; stab 一戳就破 yī chuō jiù pò break at the slightest touch 在纸上戳了一个洞 Zài zhǐ shàng chuō le yī ge dòng poke a hole in the paper 别用笔在书上戳。 Bié yòng bǐ zài shū shàng chuō. Don’t jab the book with your pen.; 2 (dialect) sprain; blunt 打排球戳了手 dǎ páiqiú chuō le shǒu sprain one’s wrist while playing volleyball 钢笔尖儿戳了。 Gāngbǐ jiānr chuō le. The nib is blunted.; 3 (dialect) stand sth. on end 把秫秸戳起来 Bǎ shújiē chuō qǐlai stand the bundle of sorghum stalks on end 有话进来说, 别在门口儿戳着。 Yǒu huà jìn láishuō, bié zài ménkǒur chuō zhe. Don’t stand in the doorway. Come in if you have something to say. noun VARIANT OF chuo1zi5 戳子 (colloquial) stamp; seal	chuo1	verb, noun

禁卫军[禁衛軍]	(dated) imperial guards	jin4wei4jun1	noun

河殇[河殤]	River Elegy, influential 1988 CCTV documentary series, said to have stimulated the Beijing Spring democracy movement of 1980s	He2shang1	unknown

始末[始末]	beginning and end—whole story 事情的始末 shìqing de shǐ-mò the whole story	shi3mo4	noun

周遭[週遭]	surrounding area 周遭静悄悄的, 不见一个人。 zhōuzāo jìngqiāoqiāo de, bùjiàn yī gèrén. It was very quiet all around with nobody in sight. 山围故国周遭在, 潮打空城寂寞回。(刘禹锡《石头城》) Shān wéi gùguó zhōuzāo zài, cháo dǎ kōngchéng jìmò huí. Hills surround the (ancient) kingdom; they never change. | The tide beats against the empty city, and silently, silently returns.	zhou1zao1	noun

银楼[銀樓]	(dated) silverware (or jeweller's) shop	yin2lou2	noun

声东击西[聲東擊西]	make a feint to the east and attack in the west	sheng1dong1-ji1xi1	idiom

倒卧[倒臥]	lie down 倒卧在地 dǎo wò zài dì lie down on the ground	dao3wo4	verb

阁揆[閣揆]	1 premier; 2 prime minister	ge2kui2	unknown

壅塞[壅塞]	be clogged up; be jammed; be congested 水道壅塞。 Shuǐdào yōng sè. The waterway is blocked up.	yong1se4	verb

类推[類推]	analogize; reason by analogy 照此类推 zhàocǐlèituī on the analogy of this 其余类推 qíyú lèituī reason out the rest by analogy	lei4tui1	verb

实例[實例]	living example; example 用实例说明 yòng shílì shuōmíng illustrate with examples	shi2li4	noun

丰沛[豐沛]	(literary) (of rainfall) plentiful 雨水丰沛 yǔshuǐ fēngpèi have plenty of rain	feng1pei4	adjective

伫列[佇列]	queue (computing)	zhu4lie4	unknown

铳[銃]	blunderbuss 鸟铳 niǎochòng an old kind of fowling piece	chong4	noun

阁下[閣下]	(courteous) Your (or His, Her) Excellency 大使阁下 Dàshǐ géxià Your Excellency Mr. Ambassador or His Excellency the Ambassador	ge2xia4	noun

升降机[升降機]	elevator; lift	sheng1jiang4ji1	unknown

博彩[博彩]	lottery; tombola 博彩业 bócǎiyè lottery industry	bo2cai3	noun

揾[搵]	1 (literary) press or rub with fingers; 2 wipe	wen4	verb

揾[搵]	1 to look for (Cantonese); 2 Mandarin equivalent: 找zhǎo [找]	wen3	unknown

筲箕[筲箕]	bamboo basin (kitchen utensil for washing rice or vegetables)	shao1ji1	noun

岭[嶺]	1 mountain; ridge 翻山越岭 fānshānyuèlǐng cross over mountain after mountain; 2 mountain range 大兴安岭 Dàxīng'ānlǐng Greater Xing’an Mountains 小兴安岭 xiǎo xīng ān lǐng Lesser Xing’an Mountains; 3 (abbreviation) the Five Ridges	ling3	noun

荃湾[荃灣]	Tsuen Wan district of New Territories, Hong Kong	Quan2wan1	unknown

生还者[生還者]	survivor	sheng1huan2zhe3	unknown

豚[豚]	1 suckling pig; 2 pig	tun2	noun

铨叙部[銓敘部]	Ministry of Civil Service, Taiwan	Quan2xu4bu4	unknown

栓[栓]	1 bolt; plug; pin 枪栓 qiāngshuān rifle bolt; 2 stopper; cork 栓式按钮 shuān shì ànniǔ bolt-push piece	shuan1	noun

正楷[正楷]	calligraphy regular script	zheng4kai3	noun

卅[卅]	number thirty 五卅惨案 Wǔ sà cǎn'àn the May 30th Massacre (1925, in Shanghai)	sa4	unknown

玺印[璽印]	seal (esp. of ruler)	xi3yin4	unknown

首推[首推]	1 considered as first or best-known 这方面的专家首推张教授。 zhè fāngmiàn de zhuānjiā shǒutuī zhāng jiàoshòu. Of the experts in this realm Professor Zhang is the first to mention.; 2 first choose; first recommend 首推营养食品 shǒutuī yíngyǎng shípǐn nutritious food first recommended; 3 first launch; first release 国内厂家首推车型 guónèi chǎngjiā shǒutuī chēxíng car model first launched by domestic company	shou3tui1	verb

谜团[謎團]	doubts and suspicions 揭开谜团 jiēkāi mítuán resolve doubts; solve the mystery	mi2tuan2	noun

隶属[隸屬]	be subordinate to; be under the jurisdiction (or command) of 隶属关系 lì shǔ guān xì relationship of administrative (or semantic, etc.) subordination 隶属医科大学的医院 lìshǔ yīkē dàxué de yīyuàn hospital attached to a medical university 这支部队隶属市警备区。 Zhè zhī bùduì lìshǔ shì jǐngbèiqū. This unit is under the command of the municipal garrison. 直辖市直接隶属国务院。 zhíxiáshì zhíjiē lìshǔ Guówùyuàn. A province-level municipality is under the direct control of the State Council.	li4shu3	verb

弧菌[弧菌]	vibrio	hu2jun1	noun

真知灼见[真知灼見]	real knowledge and deep insight; penetrating judgment	zhen1zhi1-zhuo2jian4	idiom

越王勾践[越王勾踐]	King Gou Jian of Yue (c. 470 BC), sometimes considered one of the Five Hegemons 春秋五霸	Yue4 Wang2 Gou1 Jian4	unknown

吴王阖闾[吳王闔閭]	1 King Helu of Wu (-496 BC, reigned 514-496 BC), sometimes considered one of the Five Hegemons 春秋五霸; 2 also called 吴王阖庐	Wu2wang2 He2 Lü2	unknown

楚庄王[楚莊王]	King Zhuang of Chu (reigned 613-591 BC), one of the Five Hegemons 春秋五霸	Chu3 Zhuang1wang2	unknown

秦穆公[秦穆公]	Duke Mu of Qin, the first substantial king of Qin (ruled 659-621 BC), sometimes considered one of the Five Hegemons 春秋五霸	Qin2 Mu4gong1	unknown

宋襄公[宋襄公]	Duke Xiang of Song (reigned 650-637 BC), sometimes considered one of the Five Hegemons 春秋五霸	Song4 Xiang1gong1	unknown

晋文公[晉文公]	Duke Wen of Jin (697-628 BC, reigned 636-628 BC), one of the Five Hegemons 春秋五霸	Jin4 Wen2gong1	unknown

齐桓公[齊桓公]	Duke Huan of Qi (reigned 685-643 BC), one of the Five Hegemons 春秋五霸	Qi2 Huan2gong1	unknown

瓜分[瓜分]	cut up a melon—carve up; dismember; partition; divide up 瓜分财产 guāfēn cáichǎn divide up property 瓜分领土 guāfēn lǐngtǔ carve up the territory	gua1fen1	verb

兼并[兼併]	annex (territory, property, etc.); acquire; merge; take over 企业兼并 qǐ yè jiān bìng amalgamation of enterprises 土地兼并 tǔdi jiānbìng land annexation 武力兼并邻国领土 wǔlì jiānbìng línguó lǐngtǔ annex the territories of a neighbouring country by force	jian1bing4	verb

愉悦[愉悅]	joyful; cheerful; delighted 心情愉悦 xīnqíng yúyuè in a highly delighted mood	yu2yue4	adjective

辈出[輩出]	come forth in large numbers; prolific 英雄辈出的时代 yīngxióng bèichū de shídài an age of heroes 人才辈出。 réncái bèichū Many outstanding people are coming to the fore.	bei4chu1	verb

百家争鸣[百家爭鳴]	1 contention between many schools of thought (during the Spring and Autumn and the Warring States Periods); 2 let a hundred schools of thought contend	bai3jia1-zheng1ming2	idiom

争霸[爭霸]	contend (or struggle) for hegemony; scramble (or strive) for supremacy 争霸世界 zhēngbà shìjiè contend for world domination (or hegemony)	zheng1ba4	verb

诸侯[諸侯]	dukes or princes owing loyalty to an emperor; nobles	zhu1hou2	noun

兴起[興起]	1 rise; spring up; be on the upgrade 激光是六十年代初期兴起的一门新科学。 Jīguāng shì liùshí niándài chūqī xīngqǐ de yī mén xīn kēxué. Lasers are a new branch of science which rose in the early 1960s.; 2 (literary) rise in excitement; be aroused	xing1qi3	verb

距今[距今]	1 before the present; 2 (a long period) ago	ju4jin1	unknown

半坡[半坡]	Banpo neolithic Yangshao culture archaeological site east of Xi'an 西安	Ban4po1	unknown

河姆渡[河姆渡]	Hemudu neolithic archaeological site near Ningbo in Zhejiang, going back to c. 5000 BC	He2mu3du4	unknown

遗址[遺址]	site (where sth. was) 半坡遗址(新石器时代仰韶文化遗址, 在西安东郊半坡村) bàn pō yízhǐ (xīn shíqì shídài Yǎngsháo Wénhuà yízhǐ, zài Xī'ān dōngjiāo bàn pō cūn) Banpo Village site (a neolithic site of the Yangshao Culture, at Banpo Village on the eastern outskirts of Xi’an) 古城遗址 gǔchéng yízhǐ site of an (ancient) city 平型关战役遗址 píng xíng guān zhànyì yízhǐ site of the Battle of Pingxingguan (Sept. 1937)	yi2zhi3	noun

韩战[韓戰]	Korean War (1950-1953)	Han2zhan4	unknown

投奔[投奔]	go to (a friend or a place) for shelter 投奔亲戚 Tóubèn qīnqi seek refuge with relatives; go to one’s relatives for help	tou2ben4	verb

奻[奻]		nuan2	unknown

认知[認知]	(philosophy) psychology verb cognize; understand noun cognition	ren4zhi1	unknown, noun, verb

巧言令色[巧言令色]	clever talk and an ingratiating manner 巧言令色, 鲜矣仁。(《论语》) Qiǎo yán lìng sè, xiān yǐ rén. (《Lúnyǔ》) Clever talk and an ingratiating manner are seldom found in a virtuous man.	qiao3yan2-ling4se4	idiom

区块链[區塊鏈]	blockchain (computing)	qu1kuai4lian4	unknown

轰隆[轟隆]	onomatopoeia rumble; roll 轰隆的机器声 Hōnglōng de jīqì shēng the hum of machines 雷声轰隆地响。 léishēng hōnglōng de xiǎng. Thunder rumbled.	hong1long1	unknown

党纲[黨綱]	party programme	dang3gang1	noun

醒酒[醒酒]	dispel the effects of alcohol; sober up 吃个梨醒醒酒。 Chī ge lí xǐngxǐngjiǔ. Have a pear to sober yourself up. 浓茶可以醒酒。 nóngchá kěyǐ xǐngjiǔ. Strong tea can help to dispel the effects of alcohol.	xing3//jiu3	verb

单亲[單親]	single-parent	dan1qin1	noun

逊位[遜位]	(of a king or queen) abdicate; renounce one's throne	xun4wei4	verb, noun

丰腴[豐腴]	1 (literary) VARIANT OF feng1ying2 丰盈1 (literary) full and round; well-developed; plump; 2 rich and fertile 丰腴的草场 fēngyú de cǎochǎng rich pasture; 3 sumptuous 丰腴的酒席 fēngyú de jiǔxí sumptuous feast	feng1yu2	adjective

颊[頰]	(medicine) cheek; bucca 两颊红润 liǎng jiá hóngrùn with rosy cheeks 双颊凹陷 shuāng jiá āoxiàn sunken (or hollow) cheeks	jia2	noun

蹄[蹄]	1 hoof 马有四只蹄儿。 Mǎ yǒu sì zhī tí r. A horse has four hoofs.; 2 trotter 猪蹄 zhūtí pig’s trotters	ti2	noun

晌[晌]	1 part of the day 前半晌儿 qiánbànshǎngr morning 天半晌儿 tiān bànshǎngr dusk; 2 (dialect) noon 歇晌 xiēshǎng take a midday nap or rest	shang3	noun

蔻丹[蔻丹]	(transliteration) nail polish (from “Cutex”)	kou4dan1	noun

闩[閂]	door bolt; latch 上闩 Shàngshuān fasten with a bolt (or latch) verb fasten with a bolt or latch 把门闩上 bǎ ménshuān shàng bolt the door	shuan1	noun, verb

童子鸡[童子雞]	(dialect) young chicken; broiler	tong2zi3ji1	noun

叨登[叨登]	1 (colloquial) turn things over; move things around 把衣服叨登出来晒晒。 Bǎ yīfu dāo deng chū lái shài shài. Turn your clothes out to air them.; 2 harp on things past 事情已经过去了, 还叨登什么？ Shìqing yǐjing guòqu le, hái dāo deng shénme？ Why harp on things already over and done with?	dao1deng5	verb

卤味[滷味]	food prepared by stewing in soy sauce and spices	lu3wei4	unknown

诓[誆]	deceive; hoax; cheat 我哪能诓你？ Wǒ nǎ néng kuāng nǐ？ How could I deceive you?	kuang1	verb

膀[膀]	1 upper arm; arm; 2 shoulder 肩膀 jiānbǎng shoulder; 3 wing (of a bird) 翅膀 chìbǎng wing	bang3	noun

痢疾[痢疾]	(medicine) dysentery 细菌性痢疾 xìjūnxìnglìji bacillary dysentery	li4ji5	noun

病殁[病歿]	die of illness	bing4mo4	unknown

成亲[成親]	(colloquial) get married 他们是去年成的亲。 Tāmen shì qùnián chéng de qīn. They got married last year.	cheng2//qin1	verb

妖娆[妖嬈]	(literary) enchanting; fascinating; bewitching	yao1rao2	adjective

远射[遠射]	1 (sports) (in football) long drive; long shoot; 2 military long-range shooting	yuan3she4	noun

不遗余力[不遺餘力]	spare no pains (or effort); do one's utmost; leave no stones unturned 不遗余力地提供帮助 bùyíyúlì de tígōng bāngzhù do everything to help	bu4yi2-yu2li4	idiom

敝[敝]	1 (literary) shabby; worn-out; ragged 敝衣 Bì yī ragged clothing; shabby (or worn-out) clothes; 2 decline; degenerate 时政日敝。 Shízhèng rì bì. The political situation is deteriorating by the day.; 3 self-deprecating my; our; this 敝处 bìchù my place 敝校 bìxiào my school 敝姓陈。 Bì xìng chén. My name is Chen.	bi4	adjective

心胸狭窄[心胸狹窄]	narrow-minded; intolerant	xin1xiong1 xia2zhai3	unknown

票匦[票匭]	ballot box	piao4gui3	noun

瓯[甌]	(dialect) bowl; cup 金瓯 Jīn Ōu golden cup; golden vessel 酒瓯 jiǔ'ōu wine cup; drinking vessel noun another name for Wenzhou (a city in Zhejiang Province) 瓯绣 ōuxiù Wenzhou embroidery	ou1	noun, noun

浣熊[浣熊]	(zoology) racoon	huan4xiong2	noun

助纣为虐[助紂為虐]	aid King Zhou in his tyrannical rule—aid and abet an evil-doer; abet the wicked	zhu4Zhou4wei2nüe4	idiom

崂山[嶗山]	Mount Lao (in Shandong Province)	Lao2shan1	noun

庆生[慶生]	to celebrate a birthday	qing4sheng1	unknown

年终[年終]	end of the year; year-end	nian2zhong1	noun

联网[聯網]	connect computers (or (electricity) wires, communication lines, etc.) to form a network; be online 联网发电 liánwǎng fādiàn generate (electricity) through network access 电脑联网 diànnǎo liánwǎng computer network	lian2//wang3	verb

枸杞[枸杞]	Chinese wolfberry	gou3qi3	noun

担子[擔子]	1 carrying (or shoulder) pole and the loads on it; load; burden; 2 task 我们不怕担子重, 一定要把事情办好。 Wǒmen bù pà dànzi zhòng, yīdìng yào bǎ shìqing bàn hǎo. We’re not afraid of the heavy task and are determined to do a good job.	dan4zi5	noun

华尔兹[華爾茲]	(transliteration) dance waltz	hua2er3zi1	noun

台儿庄[臺兒莊]	Tai'erzhuang district of Zaozhuang city 枣庄市Zǎozhuāngshì [枣庄市], Shandong	Tai2er2zhuang1	unknown

腰花[腰花]	scalloped pork or lamb kidneys 炒腰花 chǎo yāohuā stir-fried kidneys	yao1hua1	noun

一行[一行]	group travelling together; party 总统及其一行 zǒngtǒng jíqí yīxíng the President and accompanying officials 代表团一行十五人 Dàibiǎotuán yīxíng shíwǔ rén the fifteen-person delegation	yi1xing2	noun

风疹[風疹]	(medicine) rubella; German measles	feng1zhen3	noun

讪笑[訕笑]	ridicule; jeer; sneer at; deride 不要讥笑别人的缺点。 Bùyào jīxiào biéren de quēdiǎn. Don’t laugh at other’s shortcomings.	shan4xiao4	verb

龙须菜[龍鬚菜]	(botany) asparagus	long2xu1cai4	noun

毛肚[毛肚]	tripe (gastronomy)	mao2du3	unknown

伕[伕]	4 (dated) conscripted labourer 拉夫 lāfū pressgang	fu1	noun

守夜[守夜]	keep watch at night; take the night watch	shou3//ye4	verb

将才[將才]	1 man with military talent; man born to command troops; 2 ability to lead or command troops; generalship 别看他小小年纪, 却颇具将才。 Biékàn tā xiǎoxiǎo niánjì, què pō jù jiàngcái. Young as he is, he is a good commander.	jiang4cai2	noun

将才[將纔]	(dialect) just now; a moment ago 他将才还在这儿。 Tā jiāng cái hái zài zhèr. He was here a moment ago.	jiang1cai2	adverb

骊[驪]	(literary) pure black horse adjective black 骊龙 lílóng black dragon	li2	noun, adjective

昍[昍]		xuan1	unknown

格式化[格式化]	(computing) format 将软盘格式化 jiāng ruǎnpán géshìhuà format a floppy disk	ge2shi4hua4	verb

本省人[本省人]	1 people of this province; 2 (in Taiwan) Han Chinese people other than those who moved to Taiwan from mainland China after 1945 and their descendants	ben3sheng3ren2	unknown

外省[外省]	provinces other than where one is; other provinces	wai4sheng3	noun

货真价实[貨真價實]	1 genuine goods at a fair price; 2 through and through; out-and-out; dyed-in-the-wool; absolute 货真价实的骗子 huòzhēnjiàshí de piànzi an out-and-out swindler 货真价实的伪君子 huòzhēnjiàshí de wěijūnzǐ absolute hypocrite	huo4zhen1-jia4shi2	idiom

翌年[翌年]	next year	yi4nian2	unknown

张贴[張貼]	put up (a notice, poster, etc.) 张贴海报 zhāngtiē hǎibào put up posters 张贴通告 zhāngtiē tōnggào post a notice 禁止张贴。 Jìnzhǐ zhāngtiē. Post no bills.	zhang1tie1	verb

触手[觸手]	(zoology) tentacle	chu4shou3	noun

凭吊[憑弔]	1 to visit a place for the memories; 2 to pay homage to (the deceased)	ping2diao4	unknown

黑潮[黑潮]	geography black stream; Kuroshio; Japan Current (or Stream)	hei1chao2	noun

蜗牛[蝸牛]	(zoology) snail 食用蜗牛 shíyòng wōniú edible snail	wo1niu2	noun

踏青[踏青]	walk on the green grass—go for an outing in early spring	ta4qing1	verb

夯[夯]	1 stupid; 2 foolish; 3 silly; 4 slow-witted; 5 clumsy	ben4	unknown

夯[夯]	rammer; tamper verb; 1 ram; tamp; pound 把土夯实 bǎ tǔ hāngshí ram the earth; 2 (dialect) strike heavily 朝他背上夯一拳 Cháo tā bèishanghāng yī quán punch him on the back; 3 (dialect) carry sth. heavy on one's shoulder	hang1	noun, verb

消融[消融]	(of ice or snow) melt; thaw 冰雪消融 Bīng-xuě xiāoróng melting of ice and snow 待到冰雪消融时 dài dào bīng-xuě xiāoróng shí wait till the thaw sets in	xiao1rong2	verb

静听[靜聽]	listen attentively; pay close attention	jing4ting1	verb

清寂[清寂]	cold and quiet	qing1ji4	adjective

无常[無常]	variable; changeable 变化无常 biànhuà-wúcháng constantly changing; changeable; capricious 反复无常 fǎnfùwúcháng behave capriciously; blow hot and cold; chop and change noun astrology (Wúcháng) demon regarded as the messenger of death verb euphemistic die 一旦无常万事休。 Yīdàn wúcháng wànshì xiū. When death comes, everything is over.	wu2chang2	verb, noun, verb

樱花[櫻花]	oriental cherry 日本樱花 Rìběn yīnghuā Japanese flowering cherry	ying1hua1	noun

冼[冼]	a surname	Xian3	noun

葶[葶]	meaningless bound form 	ting2	unknown

馨[馨]	(literary) strong and pervasive fragrance 如兰之馨 rúlánzhīxīn a strong and pervasive fragrance like the orchid’s	xin1	noun

症结[癥結]	1 original meaning lump in the abdomen; 2 (figurative) crux; crucial reason 这就是问题的症结所在。 Zhè jiù shì wèntí de zhēngjié suǒzài. Therein lies the crux of the problem.	zheng1jie2	noun

苏[甦]	revive; come to 死而复苏 sǐ ér fùsū come back to life	su1	verb

蒋经国[蔣經國]	Chiang Ching-kuo (1910-1988), son of Chiang Kai-shek 蒋介石, Guomindang politician, president of ROC 1978-1988	Jiang3 Jing1guo2	unknown

自寻短见[自尋短見]	attempt suicide; commit suicide	zi4xun2 duan3jian4	unknown

杜鹃花[杜鵑花]	Indian Azalea (Rhododendron simsii Planch)	du4juan1hua1	unknown

辇[輦]	1 (archaic) man-drawn carriage; 2 imperial carriage verb (literary) travel by carriage	nian3	noun, verb

蝈蝈[蟈蟈]	1 katydid; 2 long-horned grasshopper	guo1guo5	unknown

雪藏[雪藏]	1 (dialect) freeze; refrigerate 雪藏果汁 xuěcáng guǒzhī cold fruit juice; 2 (figurative) conceal; keep idle intentionally 教练把主力雪藏起来, 决赛再派上场。 jiàoliàn bǎ zhǔlì xuěcáng qǐlai, juésài zài pài shàngchǎng. The coach kept the top players till the final.; 3 shelve; lay aside 涉毒艺人被雪藏。 Shè dú yìrén bèi xuěcáng. The star involved in drug trafficking was rested.	xue3cang2	verb

阵势[陣勢]	1 battle array (or formation); disposition of combat forces 摆开阵势 bǎikāi zhènshì deploy the ranks in battle array; array 敌人的阵势全给打乱了。 Dírén de zhènshì quán gěi dǎluàn le. The enemy formations were completely broken up.; 2 situation; condition; circumstances	zhen4shi4	noun

体态[體態]	posture; carriage 体态轻盈 tǐtàiqīngyíng have a graceful carriage	ti3tai4	noun

朱熹[朱熹]	Zhu Xi or Chu Hsi (1130-1200), also known as Master Zhu 朱子, Song dynasty Confucian writer and propagandist, founder of neo-Confucianism	Zhu1 Xi1	unknown

沉香[沉香]	1 (botany) agalloch eaglewood (Aquilaria agallocha; Aquilaria sinensis); 2 wood of this plant	chen2xiang1	noun

短见[短見]	1 short-sighted view; lack foresight; 2 suicide 自寻短见 zìxún duǎnjiàn attempt suicide; commit suicide	duan3jian4	noun

丁香[丁香]	1 lilac; 2 clove 丁香油 dīngxiāngyóu clove oil	ding1xiang1	noun

邮差[郵差]	(dated) postman; mailman	you2chai1	noun

爵士[爵士]	1 knight; 2 Sir 约翰·史密斯爵士 Yuē hàn·shǐ mìsī juéshì Sir John Smith noun (transliteration) jazz	jue2shi4	noun, noun

皋[皋]	1 (literary) marshland; waterside land 皋陆 gāolù marshland and highland; 2 marsh; bog 皋泽 gāozé wetland	gao1	noun

蝉联[蟬聯]	continue to hold (a post or title) 多次蝉联全国冠军 Duō cì chánlián quánguó guànjūn win the national championship several times running	chan2lian2	verb

法则[法則]	1 VARIANT OF gui1lv4 规律 law; regular pattern; 2 (literary) laws and regulations; 3 (literary) model	fa3ze2	noun

渔歌[漁歌]	fisherman's song 渔歌唱和 yúgē chànghè one fisherman singing and others joining in	yu2ge1	noun

胭脂[胭脂]	rouge	yan1zhi5	noun

陈年[陳年]	of long standing; preserved for a long time 陈年老酒 Chénnián lǎojiǔ old vintage wine	chen2nian2	adjective

平湖[平湖]	Pinghu county level city in Jiaxing 嘉兴Jiāxīng [嘉兴], Zhejiang	Ping2hu2	unknown

风月[風月]	1 wind and moon—scene; view 风月清幽 Fēngyuè qīngyōu tranquil and exquisite scene; 2 romantic affairs 风月场中 fēngyuèchǎngzhōng in the arena (or tournaments) of love	feng1yue4	noun

蓬莱[蓬萊]	1 fabled abode of immortals 蓬莱仙境 Pénglái xiānjìng fairyland; 2 a city in Shandong Province	Peng2lai2	noun

落脚[落腳]	1 set (or plant) one's foot on; get a foothold on 那辆公共汽车挤得无处落脚。 Nà liàng gōnggòng qìchē jǐ de wúchù luòjiǎo. That bus was too crowded to get on.; 2 stay (for a time); stop over; put up 在客店落脚 zài kèdiàn luòjiǎo put up at an inn 找个地方落个脚 Zhǎo ge dìfang luò ge jiǎo find a place to stay	luo4//jiao3	verb

昆仑[崑崙]	Kunlun Mountains	Kun1lun2	noun

曲肱而枕[曲肱而枕]	sleep with one’s head resting on one’s bent arm	qu1gong1er2zhen3	unknown

邬[鄔]	a surname	Wu1	noun

沙乌地阿拉伯[沙烏地阿拉伯]	Saudi Arabia (Tw)	Sha1wu1di4 A1la1bo2	unknown

殊荣[殊榮]	special honours	shu1rong2	noun

打滑[打滑]	1 skid around 车轮在泥里打滑。 Chēlún zài ní lǐ dǎhuá. The wheels skidded around in the mud.; 2 slip (on a slippery ground)	da3hua2	verb

考量[考量]	consider; deliberate	kao3liang5	verb

镭射[鐳射]	laser	lei2she4	noun

蓁[蓁]	1 (botany) hazel; 2 hazelnut	zhen1	noun

斑鸠[斑鳩]	(ornithology) turtledove	ban1jiu1	noun

柿子椒[柿子椒]	sweet pepper; bell pepper	shi4zi5jiao1	noun

花椒[花椒]	1 (botany) Chinese prickly ash; 2 seeds of this plant	hua1jiao1	noun

白胡椒[白胡椒]	white peppercorn	bai2hu2jiao1	unknown

黑胡椒[黑胡椒]	black pepper	hei1hu2jiao1	noun

吞金[吞金]	swallow gold (to commit suicide)	tun1//jin1	verb

入声[入聲]	(linguistics) entering tone (the fourth of the four tones in classical Chinese pronunciation, still retained in certain dialects)	ru4sheng1	noun

亚斯伯格[亞斯伯格]	Hans Asperger (1906-1980), Austrian pediatrician	Ya4si1bo2ge2	unknown

调情[調情]	flirt; dalliance 跟吧女调情 gēn bānǚ tiáoqíng flirt with a bargirl	tiao2qing2	verb

脚本[腳本]	script; scenario; libretto 脚本错误 jiǎoběn cuòwù script error 电影脚本 diànyǐng jiǎoběn film script	jiao3ben3	noun

终端用户[終端用戶]	end-user	zhong1duan1yong4hu4	unknown

莴苣[萵苣]	lettuce	wo1ju5	noun

糗[糗]	surname Qiu	Qiu3	unknown

谐音[諧音]	1 euphony; 2 (music) partials; 3 homophony verb have the same pronunciation 这两个字谐音。 zhè liǎng ge zì xiéyīn. These two characters are homophonic.	xie2yin1	noun, verb

集思广益[集思廣益]	draw on collective wisdom and absorb all useful ideas; pool the wisdom of the masses	ji2si1-guang3yi4	idiom

弹牙[彈牙]	al dente	tan2ya2	unknown

台巴子[台巴子]	Taiwanese yokel (derog.)	Tai2ba1zi5	unknown

呼啦圈[呼啦圈]	hula hoop (loanword)	hu1la1quan1	unknown

未命名[未命名]	1 untitled; 2 unnamed; 3 no name; 4 nameless; 5 unknown name	wei4ming4ming2	unknown

摩羯[摩羯]	1 Capricorn (star sign); 2 northern people in classical times, a branch of the Huns or Xiongnu 匈奴	Mo2jie2	unknown

造诣[造詣]	(academic or artistic) attainments 他是一位造诣很高的学者。 Tā shì yī wèi zàoyì hěn gāo de xuézhě. He is a scholar of great attainments. 她是一位很有造诣的歌唱家。 Tā shì yī wèi hěn yǒu zàoyì de gēchàngjiā. She’s an accomplished singer.	zao4yi4	noun

龟裂[龜裂]	1 (of parched earth) full of cracks 长期干旱, 田地龟裂。 Chángqī gānhàn, tiándì jūnliè. There has been no rain for a long time and the fields are full of cracks.; 2 VARIANT OF jun1lie4 皲裂 jūnliè (of skin) chapped; cracked	jun1lie4	verb

皲裂[皸裂]	(of skin) chapped; cracked	jun1lie4	verb

滑稽[滑稽]	folk art comic talk (popular in Shanghai, Hangzhou, and Suzhou, and similar to comic cross-talk in northern China) adjective funny; amusing; comical 他样子很滑稽。 Tā yàngzi hěn huáji. He is funny-looking. 丑角的表演非常滑稽。 Chǒujué de biǎoyǎn fēicháng huáji. The clown gave a very funny performance.	hua2ji5	noun, adjective

反骨[反骨]	(dated) treacherous nature 此人有反骨。 cǐrén yǒu fǎngǔ. The man is a traitor by nature.	fan3gu3	noun

铜板[銅板]	1 (dialect) copper coin; copper; 2 (music) copper clappers (a percussion instrument used in cross talk); 3 (metallurgy) copper sheet	tong2ban3	noun

同温层[同溫層]	stratosphere	tong2wen1ceng2	unknown

冲压[沖壓]	1 to stamp; 2 to press (sheet metal); 3 Taiwan pr. [chōngyā]	chong4ya1	unknown

螺帽[螺帽]	(mechanics) (screw) nut 紧螺母 jǐn luómǔ tighten (or fasten) the nut 蝶形螺母 diéxíng luómǔ butterfly (or wing) nut 六角螺母 liùjiǎo luómǔ hexagonal nut	luo2mao4	noun

猪瘟[豬瘟]	swine fever; hog cholera	zhu1wen1	noun

讵[詎]	(literary) [in rhetorical questions] 讵料天气骤寒。 Jù liào tiānqì zhòu hán. Who could have expected the weather to turn cold so suddenly?	ju4	adverb

良辰[良辰]	1 (literary) auspicious occasion; propitious time 良辰吉日 liángchénjírì auspicious hour and lucky day; 2 fine day; pleasant times	liang2chen2	noun

金蝉脱壳[金蟬脫殼]	slip out of a predicament like a cicada sloughing its skin—escape by cunning manoeuvring	jin1chan2-tuo1qiao4	idiom

东芝[東芝]	Toshiba, Japanese (electronics) company	Dong1zhi1	unknown

清口[清口]	tasty and refreshing	qing1kou3	adjective

锏[鐧]	(archaic) mace	jian3	noun

寡人[寡人]	I, your unworthy king (corresponding to the English royal “we”) 梁惠王曰:“寡人之于国也, 尽心焉耳矣。”(《孟子》) liáng huì wáng yuē: “guǎrén zhī yú guó yě, jìnxīn yān ěr yǐ.” King Hui of Liang said, “I have done my best for my state.”	gua3ren2	noun

铜锣[銅鑼]	gong	tong2luo2	unknown

铙钹[鐃鈸]	(music) big cymbals	nao2bo2	noun

笙箫[笙簫]	reed-pipe wind instrument and vertical bamboo flute	sheng1xiao1	unknown

福祉[福祉]	(literary) happiness; blessedness; well-being	fu2zhi3	noun

统战[統戰]	(abbreviation) VARIANT OF tong3yi1zhan4xian4 统一战线 united front verb unite; win over	tong3zhan4	noun, verb

因应[因應]	1 cope (or deal) with 因应变局 yīnyìng biànjú cope with changes 因应市场的需求 yīnyìng shìchǎng de xūqiú deal with market demands; 2 adapt oneself to; comply with; conform to 因应挑战 yīnyìng tiǎozhàn adapt oneself to challenges 针对形势的变化而妥善因应 zhēnduì xíngshì de biànhuà ér tuǒshàn yīnyìng comply with the changes of the situation	yin1ying4	verb

无视[無視]	ignore; disregard; defy 无视别国主权 Wúshì bié guó zhǔquán disregard the sovereignty of other countries 无视人民的意志 wúshì rénmín de yìzhì defy the will of the people; fly in the face of the people; defy popular sentiment	wu2shi4	verb

戈雷[戈雷]	gray (unit of absorbed dose of ionizing radiation) (loanword) (Tw)	ge1lei2	unknown

戈瑞[戈瑞]	gray (unit of absorbed dose of ionizing radiation) (loanword)	ge1rui4	unknown

佳肴[佳餚]	delicacies 美味佳肴 Měiwèi jiāyáo delicious food	jia1yao2	noun

姜饼[薑餅]	gingerbread	jiang1bing3	unknown

小幺儿[小么兒]	(dated) page boy	xiao3yao1r5	noun

踅[踅]	walk with one leg	chi4	unknown

踅[踅]	walk to and fro; turn back halfway 他在大门口踅来踅去。 Tā zài dàménkǒu xué lái xué qù. He was hanging about the gate.	xue2	verb

腊肠[臘腸]	sausage	la4chang2	noun

箍[箍]	bind round; hoop 用铁丝把桶箍上 yòng tiěsī bǎ tǒng gū shàng bind a bucket with wire 他头上箍着条毛巾。 Tā tóu shàng gū zhe tiáo máojīn. He had a towel wound round his head. noun hoop; band 铁箍 tiěgū iron hoop	gu1	verb, noun

开屏[開屏]	(of a peacock) spread its tail; display its fine tail feathers	kai1//ping2	verb

走马灯[走馬燈]	running-horse lantern (a lantern with a decorative upper panel, which revolves as the hot air ascends) 人员不断更换, 就像走马灯似的。 Rényuán bùduàn gēnghuàn, jiù xiàng zǒumǎdēng shìde. Personnel constantly shifted like on a running-horse lantern (or a merry-go-round).	zou3ma3deng1	noun

风化[風化]	morals and manners; decency 有伤风化 yǒushāng fēnghuà an offence against decency verb; 1 (geology) weather 风化的岩石 fēnghuà de yánshí weathered rock; 2 (chemistry) efflorescence	feng1hua4	noun, verb

鲠[鯁]	fishbone verb (of a fishbone) get stuck in one's throat adjective (literary) upright	geng3	noun, adjective, verb

逼肖[逼肖]	(literary) bear a close resemblance to; be the very image of	bi1xiao4	verb

逼真[逼真]	1 lifelike; true to life 这幅画画得十分逼真。 zhè fú huà huà de shífēn bīzhēn. This painting is really true to life (or lifelike).; 2 distinct; clear 听得逼真 Tīng de bīzhēn hear distinctly 看得逼真 kàn de bīzhēn have a clear view of sth.	bi1zhen1	adjective

飒[颯]	(literary) onomatopoeia rustle; sough verb wither adjective (of women) natural and unrestrained; elegant; valiant	sa4	unknown, adjective, verb

褛[褸]	front part of a Chinese-style jacket adjective (literary) worn-out; in rags (See lan2lv3 褴褛l)ánlǚ	lü3	noun, adjective

冶[冶]	smelt (metal) 冶铸 yězhù smelt and found adjective (literary) (pejorative) seductively dressed or made up 妖冶 yāoyě seductive; bewitching	ye3	verb, adjective

班师[班師]	(literary) withdraw troops from the front; return after victory 班师归来 bānshī guīlái make a triumphant return	ban1shi1	verb

夔[夔]	1 one-legged mountain demon of Chinese (mythology); 2 Chinese mythical figure who invented (music) and dancing; 3 Chinese rain god; 4 surname Kui	Kui2	unknown

犹自[猶自]	(literary) still 忆及此事, 犹自心惊。 Yìjí cǐshì, yóuzì xīnjīng. Even to this day, I still shudder at the very thought of it.	you2zi4	adverb

姘[姘]	have illicit relations with; commit adultery	pin1	verb

造化[造化]	(literary) noun Creator; Nature; Creation 造化钟神秀, 阴阳割昏晓。(杜甫《登泰山》) zàohuà zhōng shénxiù, yīnyáng gē hūnxiǎo. Here Creation concentrated unearthly glory, | Dark north slope, the sunlit south divide dusk and dawn. 造化赋形, 支体必双, 神理为用, 事不孤立。(刘勰《文心雕龙》) zàohuà fù xíng, zhī tǐ bì shuāng, shén lǐ wéi yòng, shì bù gūlì. Nature, creating living beings, endows them with limbs in pairs. The Divine Reason operates in such a way that nothing stands alone. verb (of Nature or presumed divine force) create; make 夺天地造化之功 duó tiāndì zàohuà zhī gōng rob Heaven and Earth of their creative powers	zao4hua4	unknown, noun, verb

道台[道臺]	(archaic) intendant of a circuit (an administrative division)	dao4tai2	noun

公仔[公仔]	1 doll; 2 cuddly toy	gong1zai3	unknown

单帮[單幫]	(dated) travelling trader working on his own 跑单帮 pǎo dānbāng travel around trading on one’s own	dan1bang1	noun

锂[鋰]	(chemistry) lithium (Li) 锂电池 lǐdiànchí lithium cell (or battery)	li3	noun

迳自[逕自]	1 on one's own; 2 without consulting others	jing4zi4	unknown

衣衾[衣衾]	(dated) burial clothes 衣衾棺 yīqīn guān burial clothes and coffin	yi1qin1	noun

螭[螭]	(mythology) hornless dragon-like animal (as decorative motif in Chinese architecture, arts and crafts, etc.) meaningless bound form VARIANT OF chi1 魑	chi1	noun

冷杉[冷杉]	(botany) fir; fir tree	leng3shan1	noun

雏凤[雛鳳]	young phoenix—talented young 雏凤清于老凤声。(李商隐《韩冬郎即席为诗相送因成二绝》) chúfèng qīng yú lǎo fèng shēng. A young phoenix sings better than an old one. [said of a son surpassing his father or of a student surpassing his master].	chu2feng4	noun

嶒[嶒]	1 lofty; 2 precipitous	ceng2	unknown

崚[崚]	lofty (as of mountain)	leng2	unknown

诸子百家[諸子百家]	(history) various schools of thought and their exponents during the period from pre-Qin times to the early Han Dynasty	zhu1zi3-bai3jia1	noun

无异[無異]	no different from; tantamount to; as good as 这件复制品几乎与原作无异。 Zhè jiàn fùzhìpǐn jīhū yǔ yuánzuò wúyì. The reproduction is almost as good as the original. 他撤回声明无异于表示歉意。 Tā chèhuí shēngmíng wúyì yú biǎoshì qiànyì. The withdrawal of his statement is tantamount to an apology.	wu2yi4	verb

弃之如敝屣[棄之如敝屣]	cast away like a pair of worn-out shoes	qi4 zhi1 ru2 bi4xi3	idiom

敝屣[敝屣]	(literary) worn-out shoes; worthless thing (See qi4zhi1ru2bi4xi3 弃之如敝屣;)shi4ru2bi4xi3 视如敝屣	bi4xi3	noun

细嚼慢咽[細嚼慢嚥]	to eat slowly (idiom)	xi4jiao2man4yan4	unknown, idiom

与世隔绝[與世隔絕]	be secluded from the real world; withdraw into one's shell 过着与世隔绝的日子 guò zhe yǔshìgéjué de rìzi live an isolated life	yu3shi4-ge2jue2	idiom

芃[芃]	meaningless bound form 	peng2	unknown

运将[運將]	driver (of a taxi etc) ((loanword) from Japanese) (Tw)	yun4jiang4	unknown

马杀鸡[馬殺雞]	massage (loanword)	ma3sha1ji1	unknown

铁马[鐵馬]	(literary) iron-clad (or armoured) horses—strong mounted forces 夜阑卧听风吹雨, 铁马冰河入梦来。(陆游《十一月四日风雨大作》) yèlán wò tīng fēng chuī yǔ, tiěmǎ bīnghé rùmèng lái. Night deepening, I lie and listen to winds buffeting the rain, ｜ And iron-clad horses over frozen rivers come charging into my dreams. (See jin1ge1tie3ma3 金戈铁马) noun tinkling pieces of metal hanging from the eaves of pagodas, temples, etc.; metal windchimes	tie3ma3	noun, noun

相称[相稱]	call each other; address each other (as ...) 以姐弟相称 Yǐ jiědì xiāngchēng address each other as brother and sister	xiang1cheng1	verb

相称[相稱]	match; suit 这头巾跟你的年龄不相称。 Zhè tóujīn gēn nǐ de niánlíng bù xiāngchèn. This kerchief doesn’t suit a person of your age. 这两种颜色配在一起很相称。 Zhè liǎng zhǒng yánsè pèi zài yīqǐ hěn xiāngchèn. The two colours match very well. 你这种工作作风与党员的称号很不相称。 Nǐ zhèzhǒng gōngzuò zuòfēng yǔ dǎngyuán de chēnghào hěn bù xiāngchèn. Your work style is not worthy of a Party member.	xiang1chen4	adjective

速配[速配]	1 fast matchmaking; 2 speed dating; 3 (coll.) (Tw) (of a couple) to be a good match	su4pei4	unknown

直译[直譯]	word-for-word (or literal) translation (opp. 意译)	zhi2yi4	verb

优酪乳[優酪乳]	yogurt (loanword) (Tw)	you1luo4ru3	unknown

奇异果[奇異果]	1 kiwi fruit; 2 Chinese gooseberry	qi2yi4guo3	unknown

太白粉[太白粉]	1 cornstarch; 2 potato starch	tai4bai2fen3	unknown

洗面乳[洗面乳]	cleansing lotion	xi3mian4ru3	unknown

洗发精[洗髮精]	(liquid) shampoo	xi3fa4jing1	unknown

保险套[保險套]	condom M: 只zhī [只]	bao3xian3tao4	unknown

子宫颈癌[子宮頸癌]	cervical cancer	zi3gong1jing3ai2	unknown

超音波[超音波]	1 ultrasound; 2 ultrasonic wave	chao1yin1bo1	unknown

卷舌[卷舌]	(in pronunciation) curl up the tip of the tongue	juan3she2	verb

羁押[羈押]	(literary) detain; take into custody	ji1ya1	verb

政绩[政績]	achievements of one's official career	zheng4ji4	noun

弄璋[弄璋]	(dated) play with a jade tablet—a son is born (from the early custom of giving a baby boy a jade tablet to play with, symbol of male superiority) (See nong4wa3 弄瓦)	nong4zhang1	verb

削发[削髮]	cut off the hair 削发为僧 xuēfàwéisēng have one’s head shaved to enter the monkhood ; take the tonsure 削发为尼 xuēfàwéiní have one’s head shaved to enter the nunhood; take the tonsure	xue1fa4	verb

维权[維權]	(abbreviation) safeguard legitimate rights and interests 为消费者维权 wèi xiāofèizhě wéiquán protect consumers’ interests	wei2quan2	verb

简报[簡報]	bulletin; brief report 会议简报 huìyì jiǎnbào conference bulletin; brief reports on conference proceedings	jian3bao4	noun

累累[纍纍]	1 (literary) (of fruit, achievements etc) clusters of; 2 piles of; 3 heaps of; 4 gaunt; 5 haggard; 6 wretched; 7 Taiwan pr. [lěilěi]	lei2lei2	unknown

犹[猶]	(literary) verb just as; like 虽死犹生 suīsǐyóushēng live on in spirit adverb still 犹未定夺 yóu wèi dìngduó still undecided; not decided yet 犹有可为 yóuyǒukěwéi can still do something about it	you2	unknown, verb, adverb

暴戾[暴戾]	(literary) ruthless and tyrannical; cruel and fierce	bao4li4	adjective

木屐[木屐]	clogs	mu4ji1	noun

精虫[精蟲]	physiology spermatozoon; sperm	jing1chong2	noun

踢毽子[踢毽子]	kick the shuttlecock (as a game)	ti1 jian4zi5	unknown

软实力[軟實力]	soft power	ruan3shi2li4	noun

儦[儦]	walking to and fro	biao1	unknown

伉[伉]	(archaic) verb (of a married couple) fit for each other; equal to adjective high; mighty	kang4	unknown, adjective, verb

从无到有[從無到有]	grow out of nothing	cong2wu2dao4you3	unknown

何去何从[何去何從]	what course to follow 何去何从, 速作抉择。 Héqùhécóng, sù zuò juézé. What course to follow—that is a question you must quickly decide for yourself.	he2qu4-he2cong2	idiom

产能[產能]	production capacity	chan3neng2	unknown

供应链[供應鏈]	supply chain	gong1ying1lian4	unknown

出逃[出逃]	flee 出逃国外 Chūtáo guówài flee the country	chu1tao2	verb

持久战[持久戰]	protracted war; protracted warfare	chi2jiu3zhan4	unknown

越演越烈[越演越烈]	1 to be intensifying; 2 to be getting worse and worse; 3 to start to run rampant	yue4yan3yue4lie4	unknown

手语[手語]	sign language; dactylology	shou3yu3	noun

莲雾[蓮霧]	(botany) wax-apple; wax-jambo	lian2wu4	noun

纵使[縱使]	(literary) even if; even though	zong4shi3	conjunction

忍辱负重[忍辱負重]	endure humiliation in order to carry out an important mission	ren3ru3-fu4zhong4	idiom

顾全大局[顧全大局]	take the interests of the whole into account; consider the situation as a whole	gu4quan2da4ju2	unknown

鞠躬尽瘁[鞠躬盡瘁]	bend oneself to a task and exert oneself to the utmost; spare no effort in the performance of one's duty 鞠躬尽瘁, 死而后已 jūgōngjìncuì, sǐ'érhòuyǐ bend one’s back to the task until one’s dying day; give one’s all till the very end	ju1gong1-jin4cui4	idiom

病入膏肓[病入膏肓]	The disease has attacked the vitals.—beyond cure 他已病入膏肓, 自知时日无几。 tā yǐ bìngrùgāohuāng, zìzhī shírì wújǐ. He is beyond cure and knows his days are numbered.	bing4ru4gao1huang1	idiom

附议[附議]	second a motion; support a proposal 我附议！ Wǒ fùyì! I second the motion!	fu4yi4	verb

义和团[義和團]	(history) Yihetuan (an anti-imperialist armed organization established by north China peasants and handicraftsmen in 1900)	Yi4he2tuan2	noun

缔约[締約]	conclude (or sign) a treaty 缔约双方 dìyuēshuāngfāng both contracting parties	di4yue1	verb

辅仁大学[輔仁大學]	1 Fu Jen Catholic University of Peking (from 1925), forerunner of Beijing Normal University 北京师范大学; 2 Fu Jen Catholic University in New Taipei City, Taiwan	Fu3ren2 Da4xue2	unknown

饯别[餞別]	give a farewell dinner 饯别友人 jiànbié yǒurén give a friend a farewell dinner	jian4bie2	verb

成事不足，败事有余[成事不足，敗事有餘]	1 unable to accomplish anything but liable to spoil everything (idiom); 2 unable to do anything right; 3 never make, but always mar	cheng2shi4bu4zu2, bai4shi4you3yu2	unknown, idiom

伏笔[伏筆]	hint foreshadowing later developments in a story, essay, etc.; foreshadowing 这件事为以后情节的发展埋下了伏笔。 zhè jiàn shì wèi yǐhòu qíngjié de fāzhǎn máixià le fúbǐ. This episode carries a foreshadowing of what is to follow later on in the story.	fu2bi3	noun

制衡[制衡]	check and balance 在大国之间起着制衡的作用 Zài dàguó zhījiān qǐ zhe zhìhéng de zuòyòng hold the balance between big powers	zhi4heng2	verb

覗[覗]	peek	si1	unknown

适者生存[適者生存]	survival of the fittest	shi4zhe3-sheng1cun2	idiom

背道而驰[背道而馳]	run in the opposite direction; run counter to 和他们的愿望背道而驰 hé tāmen de yuànwàng bèidào'érchí run counter to their intentions; opposite to their intentions 同改革的要求背道而驰 tóng gǎigé de yāoqiú bèidào'érchí contradict the whole purpose of reforms 与党的方针背道而驰 yǔdǎng de fāngzhēn bèidào'érchí in diametrical opposition to the Party’s policy	bei4dao4er2chi2	idiom

物竞天择[物競天擇]	survival of the fittest in natural selection	wu4jing4-tian1ze2	idiom

忿忿不平[忿忿不平]	1 to feel indignant; 2 to feel aggrieved	fen4fen4bu4ping2	unknown

塞责[塞責]	not do one's job conscientiously; perform one's duties perfunctorily (See fu1yan5se4ze2 敷衍塞责)	se4ze2	verb

而后[而後]	then; after that; afterwards 我们先研究一下, 然后再决定。 Wǒmen xiān yánjiū yīxià, ránhòu zài juédìng. We’ll consider the problem carefully before coming to any decision. 我们看了一场电影, 然后就回家了。 Wǒmen kàn le yī chǎng diànyǐng, ránhòu jiù huíjiā le. We saw a film, and then (we) went home.	er2hou4	conjunction

定能[定能]	to be definitely able (to do sth)	ding4neng2	unknown

莫大[莫大]	greatest; utmost 莫大的愤慨 mò dà de fènkǎi utmost indignaion 莫大的侮辱 mò dà de wǔrǔ gross insult 莫大的幸福 mò dà de xìngfú greatest happiness; bliss 感到莫大的光荣 Gǎndào mòdà de guāngróng feel greatly honoured	mo4da4	adjective

纸浆[紙漿]	paper pulp; pulp	zhi3jiang1	noun

纸板[紙板]	paperboard; cardboard 纸板盒(箱) zhǐbǎnhé(xiāng) cardboard case or box; carton	zhi3ban3	noun

鼩鼱[鼩鼱]	(zoology) shrew	qu2jing1	noun

啮齿[嚙齒]	a rodent (rat, rabbit etc)	nie4chi3	unknown

变速器[變速器]	gearbox; transmission	bian4su4qi4	unknown

谷物[穀物]	1 cereal; grain; 2 (abbreviation) VARIANT OF gu3lei4zuo4wu4 谷类作物 general name for rice, wheat, millet, sorghum, maize, etc.; cereal crops	gu3wu4	noun

蜂鸟[蜂鳥]	(ornithology) hummingbird	feng1niao3	noun

明文规定[明文規定]	written rules (or provisions); explicit terms; expressly stated	ming2wen2 gui1ding4	unknown

受众[受眾]	audience	shou4zhong4	noun

饲育[飼育]	(literary) raise; feed	si4yu4	verb

木乃伊[木乃伊]	mummy	mu4nai3yi1	noun

金字塔[金字塔]	pyramid	jin1zi4ta3	noun

都会[都會]	big city; metropolis	du1hui4	noun

涂装[塗裝]	1 painted ornament; 2 livery (on airline or company vehicle)	tu2zhuang1	unknown

舫[舫]	boat 画舫 huàfǎng gaily-painted pleasure-boat	fang3	noun

疏浚[疏浚]	dredge 疏浚港口 shūjùn gǎngkǒu dredge a harbour 疏浚水道 Shūjùn shuǐdào dredge the waterways	shu1jun4	verb

浚渫[浚渫]	to dredge	jun4xie4	unknown

桦树[樺樹]	(botany) birch	hua4shu4	noun

岷山[岷山]	Mount Min (along the border between Sichuan and Gansu Provinces)	min2 shan1	unknown

晨曦[晨曦]	first rays of the morning sun	chen2xi1	noun

测绘[測繪]	survey and map; map 地形测绘 Dìxíng cèhuì topographical survey	ce4hui4	verb

铨[銓]	(archaic) steelyard; balance verb (literary); 1 weigh; measure; judge; 2 select; choose	quan2	noun, verb

浮想联翩[浮想聯翩]	thoughts thronging one's mind 浮想联翩, 夜不能寐。 Fúxiǎngliánpiān, yè bùnéng mèi. Thoughts thronged my mind and I could not sleep.	fu2xiang3-lian2pian1	idiom

竣工[竣工]	(of a project) completed (opp. 开工) 竣工仪式 jùngōng yíshì completion ceremony 这座大楼已提前竣工。 Zhè zuò dàlóu yǐ tíqián jùngōng. The building has been completed ahead of schedule.	jun4//gong1	verb

歼灭[殲滅]	annihilate; wipe out; destroy 歼灭性的打击 jiānmiè xìng de dǎjī crushing blow; smashing blow 歼灭敌人有生力量 jiānmiè dírén yǒushēng lìliàng wipe out the enemy’s effective strength 歼灭一切敢于入侵之敌 jiānmiè yīqiè gǎnyú rùqīn zhī dí destory any enemy that should dare to intrude	jian1mie4	verb

齿轮[齒輪]	gear wheel; gear 伞齿轮 sǎn chǐlún bevel gear 外齿轮 wài chǐlún external gear 斜齿轮 xié chǐlún helical gear 正齿轮 zhèng chǐlún spur gear	chi3lun2	noun

泷[瀧]	Shuangshui River (in Guangdong Province)	Shuang1	noun

泷[瀧]	(dialect) rapids [often in place names] 七里泷 qī lǐ lóng Qililong (a village in Zhejiang Province)	long2	noun

藉由[藉由]	1 by means of; 2 through; 3 by	jie4you2	unknown

涵盖[涵蓋]	cover; contain; encompass 涵盖多种学科的计划 hángài duōzhǒng xuékē de jìhuà programme covering a wide range of disciplines	han2gai4	verb

全方位[全方位]	all-round	quan2fang1wei4	adjective

业界[業界]	business circles	ye4jie4	noun

孩提[孩提]	(literary) early childhood; infancy 我在故乡度过了孩提时代。 wǒ zài gùxiāng dùguò le háití shídài. I spent my childhood in my hometown.	hai2ti2	noun

扉页[扉頁]	printing title page	fei1ye4	noun

如火如荼[如火如荼]	like a raging fire 全国掀起了如火如荼的改革热潮。 Quánguó xiānqǐ le rúhuǒrútú de gǎigé rècháo. Reform is catching on like fire throughout the country.	ru2huo3-ru2tu2	idiom

物是人非[物是人非]	The scenery remains the same but the people are changed. or Things are unchanged but the people are gone.	wu4shi4-ren2fei1	idiom

文法[文法]	1 rules of composition and rhetoric; 2 VARIANT OF yu3fa3 语法 grammar 中国文法 Zhōngguó wénfǎ Chinese grammar	wen2fa3	noun

程式[程式]	1 form; pattern; formula 程式动作 chéngshì dòngzuò stylized movements (as in Beijing opera) 公文程式 gōngwén chéngshì forms and formulas of official documents; 2 procedure; course	cheng2shi4	noun

软体[軟體]	1 software (Tw); 2 soft-bodied (animal)	ruan3ti3	unknown

学测[學測]	abbr. for 大学学科能力测验  Dàxué Xuékē Nénglì Cèyàn [大学学科能力测验]	Xue2ce4	unknown

联考[聯考]	entrance examination	lian2kao3	unknown

简讯[簡訊]	news in brief	jian3xun4	noun

锦鲤[錦鯉]	koi (Cyprinus carpio haematopterus)	jin3li3	unknown

鲜少[鮮少]	1 very few; 2 rarely	xian3shao3	unknown

堆肥[堆肥]	argriculture compost; compost heap	dui1fei2	noun

厨余[廚餘]	1 kitchen waste; 2 food waste (recycling)	chu2yu2	unknown

崁[崁]	[in place names] 赤崁楼 Chìkànlóu Chikan Tower (a historic site in southern Taiwan)	kan4	noun

著称[著稱]	(literary) celebrated; famous 以风景优美著称 yǐ fēngjǐng yōuměi zhùchēng celebrated for its scenic beauty; well known for its lovely scenery 杭州以西湖著称于世。 Hángzhōu yǐ Xī Hú zhùchēng yú shì. Hangzhou is world-famous for its West Lake.	zhu4cheng1	verb

祝融[祝融]	(mythology) God of Fire	Zhu4rong2	noun

流标[流標]	1 fail to be sold at auction (because of no bids) 拍卖品全部成交, 无一流标。 pāimài pǐn quánbù chéngjiāo, wú yī liúbiāo. All the items were bid for and sold at the auction.; 2 become abortive tender 该项目由于竞标者均未达要求而流标。 Gāi xiàngmù yóuyú jìngbiāo zhě jūn wèi dá yāoqiú ér liúbiāo. The project became abortive because none of the bidders met the requirements.	liu2biao1	verb

无地自容[無地自容]	nowhere to hide one's shame; feel too ashamed to show one's face; look for a hole to crawl into	wu2di4-zi4rong2	idiom

拜伦[拜倫]	George Byron (1788-1824), English poet	Bai4lun2	unknown

叠罗汉[疊羅漢]	(sports) acrobatics pyramid	die2 luo2han4	noun

学潮[學潮]	student unrest; campus upheaval 闹学潮 nào xuécháo stage student strike	xue2chao2	noun

为虎作伥[為虎作倀]	play the jackal to the tiger—help a rascal commit villainy	wei4hu3-zuo4chang1	idiom

觑[覷]	narrow (one's eyes); squint 他觑着眼睛仔细地看一幅画。 Tā qū zhe yǎnjing zǐxì de kàn yī fú huà. He was studying a painting with narrowed eyes. 这英俊小伙子走过她身边, 她偷偷地觑了他一眼。 Zhè yīngjùn xiǎohuǒzi zǒuguò tā shēnbiān, tā tōutōu de qū le tā yī yǎn. She had a squint at the handsome young man as he passed by.	qu1	verb

觑[覷]	(literary) look; gaze 面面相觑 miànmiànxiāngqù look at each other in blank dismay; gaze at each other in speechless despair	qu4	verb

玄关[玄關]	1 (Buddhism) entrance to (Buddhism); 2 (dated) front door; 3 architecture entrance hall (of an apartment or a house); vestibule; porch	xuan2guan1	noun

儒雅[儒雅]	(literary) scholarly and refined; well-educated 儒雅风度 rúyǎ fēngdù scholarly bearing	ru2ya3	adjective

恂恂自下[恂恂自下]	be modest; be unassuming	xun2 xun2 zi4 xia4	unknown

烟斗[煙斗]	1 (tobacco) pipe; 2 ceramic ball or mouthpiece of an opium pipe	yan1dou3	noun

饯行[餞行]	give a farewell dinner 设宴为他饯行 shèyàn wéi tā jiànxíng give a farewell dinner for him	jian4xing2	verb

接风[接風]	give a welcome dinner (to a visitor from afar)	jie1//feng1	verb

晾晒[晾曬]	sun; air; sun-cure 晾晒稻米 liàngshài dàomǐ field the rice 把被褥彻底晾晒一下 bǎ bèirù chèdǐ liàngshài yīxià give the bedding a thorough airing	liang4shai4	verb

棉絮[棉絮]	1 cotton fibre; 2 cotton wadding (for a quilt, etc.); cotton batting	mian2xu4	noun

褴褛[襤褸]	(literary) ragged; shabby 褴褛衣衫 lánlǚ yīshān tattered garments (See yi1shan1lan2lv3 衣衫褴褛)	lan2lü3	adjective

栖住[棲住]	1 to dwell; 2 to live	qi1zhu4	unknown

地检署[地檢署]	district prosecutor's office	di4jian3shu3	unknown

都更案[都更案]	urban development project	du1geng1an4	unknown

口臭[口臭]	(-//-) have bad breath noun (medicine) halitosis; ozostomia	kou3chou4	verb, noun

重荷[重荷]	(literary) heavy burden (or responsibilities) 肩负重荷 jiānfù zhòng hè carry heavy responsibilities; burdened with heavy duties	zhong4he4	noun

沆瀣[沆瀣]	(literary) evening mist	hang4xie4	noun

洞察[洞察]	see clearly; have an insight into; discern 洞察是非 dòngchá shìfēi see clearly the rights and wrongs of the case; distinguish between right and wrong 洞察一切 dòngchá yīqiè have a keen insight into matters	dong4cha2	verb

乱码[亂碼]	(computing) error (or unintelligible) codes	luan4ma3	noun

御史[御史]	imperial censor ((formal) title of a dynastic official)	yu4shi3	unknown

兄台[兄臺]	brother (polite appellation for a friend one's age)	xiong1tai2	unknown

大驾[大駕]	humorous your good self—you	da4jia4	noun

平易[平易]	1 unassuming; amiable; 2 (of language, style, etc.) simple; easy; plain 用平易的表达 Yòng píngyì de biǎodá in simple words	ping2yi4	adjective

更上一层楼[更上一層樓]	climb one storey higher—attain a yet higher goal; scale new heights 欲穷千里目, 更上一层楼。(王之涣《登鹳雀楼》) Yù qióng qiānlǐ mù, gèngshàngyīcénglóu. If you would command a prospect of a thousand li, climb one storey higher.	geng4 shang4 yi1 ceng2 lou2	idiom

洗耳恭听[洗耳恭聽]	listen with respectful attention	xi3er3-gong1ting1	idiom

摇篮曲[搖籃曲]	(music) lullaby; berceuse; cradle song	yao2lan2qu3	unknown

帖子[帖子]	1 invitation 请帖 qǐngtiě invitation card; invitation; 2 note; card 字帖儿 zìtiěr brief note; 3 internet post; posting; thread 顶帖 Dǐng tiě bump a thread 发帖 fātiě post; put up a post 回帖 huítiě reply to one’s post; post a reply	tie3zi5	noun

猣[猣]	dog giving birth to three puppies	zong1	unknown

鸮[鴞]	(ornithology) owl	xiao1	noun

熟门熟路[熟門熟路]	familiar road and familiar door—things that one knows well	shu2men2-shu2lu4	idiom

双面[雙面]	two-sided; double-edged; double-faced; reversible	shuang1mian4	adjective

擀面杖[擀麵杖]	rolling pin	gan3mian4zhang4	noun

籴[糴]	(dated) buy in (grain) (opp. 粜 tiào)	di2	verb

岘港[峴港]	Da Nang or Danang, Vietnam	Xian4gang3	unknown

荷包[荷包]	1 small bag (for carrying money and odds and ends); pouch; 2 pocket (in a garment)	he2bao5	noun

远道而来[遠道而來]	come a long way; come from afar	yuan3dao4er2lai2	unknown

斡旋[斡旋]	mediate 由于他从中斡旋, 双方的争端得到了解决。 Yóuyú tā cóng zhōng wòxuán, shuāngfāng de zhēngduān dédào le jiějué. Through his mediation, the dispute between the two parties was settled. noun legal good offices	wo4xuan2	verb, noun

趸[躉]	wholesale 趸售 dǔnshòu (sell) wholesale verb buy wholesale 趸货 dǔnhuò buy goods wholesale	dun3	adverb, verb

琼[瓊]	(literary) fine jade 琼阁 qiónggé jewelled palace	qiong2	noun

甯[甯]	a surname	Ning4	noun

钧[鈞]	(archaic) jun (unit of weight, equal to 30 jin) 千钧之力 Qiān jūn zhī lì as powerful as being able to lift a thousand jun pronoun (literary) (courteous) [said to one's seniors or superiors] you; your 钧命 jūnmìng your instructions	jun1	measure word, noun, pronoun

翊[翊]	(literary) assist (a ruler) 翊戴 yìdài assist and support (a ruler)	yi4	verb

