科普[科普]	(abbreviation) popular science	ke1pu3	noun

温居[溫居]	celebrate the move into a new home; house-warming 举行温居宴会 Jǔxíng wēnjū yànhuì have (or throw) a house-warming party	wen1//ju1	verb

鹬蚌相争[鷸蚌相爭]	lit. sandpiper and clam war together (and the fisherman catches both) (idiom); fig. neighbors who can't agree lose out to a third party	yu4bang4xiang1zheng1	unknown, idiom

进位[進位]	(mathematics) carry (a number, as in addition or subtraction)	jin4//wei4	verb

伪军[偽軍]	puppet army or soldier; quisling army	wei3jun1	noun

袒露[袒露]	expose (part of one's body) 袒露上身 tǎnlù shàngshēn be bare from the waist up	tan3lu4	verb

东家[東家]	(dated) [form of address used by an employee to his employer, or a tenant-peasant to his landlord] master; boss	dong1jia5	noun

碌碡[碌碡]	argriculture stone roller (for threshing grain, levelling a threshing floor, etc.) (碡碡 zhóu)	liu4zhou5	noun

桅灯[桅燈]	1 mast head light; range light; 2 barn lantern	wei2deng1	noun

留得青山在，不怕没柴烧[留得青山在，不怕沒柴燒]	While the green hills last, there'll be wood to burn (idiom). Where there's life there's hope.	liu2de5qing1shan1zai4, bu4pa4mei2chai2shao1	unknown, idiom

烧酒[燒酒]	spirit usu. distilled from sorghum or maize; white spirits	shao1jiu3	noun

手风琴[手風琴]	accordion 六角手风琴 Liù jiǎo shǒufēngqín concertina	shou3feng1qin2	noun

染色体[染色體]	(biology) chromatosome; chromosome 染色体学 rǎnsètǐ xué chromosomology 染色体组 rǎn sè tǐ zǔ genome 染色体基因 rǎnsètǐ jīyīn chromogene 染色体畸变 rǎn sè tǐ jī biàn chromosome aberration 染色体配对 rǎnsètǐ pèiduì chromosome pairing 染色体图谱 rǎnsètǐ túpǔ chromosome map 染色体异常 rǎn sè tǐ yì cháng chromosome abnormality 染色体遗传学 rǎnsètǐ yíchuánxué chromosome genetics	ran3se4ti3	noun

蚂蟥[螞蟥]	(zoology) leech 水蛭 shuǐzhì water leech	ma3huang2	noun

包治百病[包治百病]	guaranteed to cure all illnesses; cure-all	bao1zhi4bai3bing4	unknown

皇历[皇曆]	almanac	huang2li5	noun

刺青[刺青]	tattoo 他背上满是刺青。 Tā bèishang mǎnshì cìqīng. His back is covered in tattoos. verb tattoo; have a tattoo done (on) 让人在手臂上刺青 Ràngrén zài shǒubì shàng cìqīng have a tattoo done on one’s arm	ci4qing1	noun, verb

没有规矩不成方圆[沒有規矩不成方圓]	(well-known phrase) You cannot draw circles and squares without a pair of compasses and a square.—Nothing can be accomplished without norms or standards.	mei2you3 gui1ju5 bu4 cheng2 fang1yuan2	unknown

和服[和服]	kimono	he2fu2	noun

热血青年[熱血青年]	ardent youth	re4xue4 qing1nian2	unknown

白目[白目]	1 (slang) stupid; 2 moron	bai2mu4	unknown

天兵[天兵]	1 troops from heaven—an invincible army; 2 (archaic) imperial troops	tian1bing1	noun

请辞[請辭]	to ask sb to resign from a post	qing3ci2	unknown

获准[獲準]	get (or obtain) permission	huo4zhun3	verb

馠[馠]		han1	unknown

细腰[細腰]	slender waist (esp. of a woman)	xi4yao1	noun

池鱼之殃[池魚之殃]	disaster for the fish in the moat—trouble not of one's own making (See cheng2men2shi1huo3yang1ji2chi2yu2 城门失火,) 殃及池鱼	chi2yu2zhi1yang1	idiom

宠信[寵信]	be specially fond of and trust unduly (a subordinate)	chong3xin4	verb

